PokerStars Zoom Hand #258128597009:  Hold'em No Limit (€0.01/€0.02) [ADM ID: M62C63044C87BABT] - 2025/10/15 0:18:47 CET [2025/10/14 18:18:47 ET]
Table 'Sirio' 6-max Seat #1 is the button
Seat 1: mashallahh (€7.47 in chips) 
Seat 2: gas888 (€11.61 in chips) 
Seat 3: caduceus369 (€2 in chips) 
Seat 4: teicano98 (€0.75 in chips) 
Seat 5: Warterror90 (€6.56 in chips) 
Seat 6: CarlaBBruni (€3.09 in chips) 
gas888: posts small blind €0.01
caduceus369: posts big blind €0.02
*** HOLE CARDS ***
Dealt to caduceus369 [9c Jd]
teicano98: folds 
Warterror90: folds 
CarlaBBruni: folds 
mashallahh: folds 
gas888: folds 
Uncalled bet (€0.01) returned to caduceus369
caduceus369 collected €0.02 from pot
caduceus369: doesn't show hand 
*** SUMMARY ***
Total pot €0.02 | Rake €0 
Seat 1: mashallahh (button) folded before Flop (didn't bet)
Seat 2: gas888 (small blind) folded before Flop
Seat 3: caduceus369 (big blind) collected (€0.02)
Seat 4: teicano98 folded before Flop (didn't bet)
Seat 5: Warterror90 folded before Flop (didn't bet)
Seat 6: CarlaBBruni folded before Flop (didn't bet)



PokerStars Zoom Hand #258128602491:  Hold'em No Limit (€0.01/€0.02) [ADM ID: M62C63044C87BABT] - 2025/10/15 0:19:13 CET [2025/10/14 18:19:13 ET]
Table 'Sirio' 6-max Seat #1 is the button
Seat 1: Crock361 (€1.67 in chips) 
Seat 2: caduceus369 (€2.01 in chips) 
Seat 3: Fraxasso (€4.12 in chips) 
Seat 4: gas888 (€2.60 in chips) 
Seat 5: mashallahh (€5.44 in chips) 
Seat 6: diesel197474 (€2.77 in chips) 
caduceus369: posts small blind €0.01
Fraxasso: posts big blind €0.02
*** HOLE CARDS ***
Dealt to caduceus369 [Jc Jd]
gas888: folds 
mashallahh: folds 
diesel197474: folds 
Crock361: folds 
caduceus369: raises €0.04 to €0.06
Fraxasso: raises €0.18 to €0.24
caduceus369: raises €0.48 to €0.72
Fraxasso: folds 
Uncalled bet (€0.48) returned to caduceus369
caduceus369 collected €0.48 from pot
caduceus369: doesn't show hand 
*** SUMMARY ***
Total pot €0.48 | Rake €0 
Seat 1: Crock361 (button) folded before Flop (didn't bet)
Seat 2: caduceus369 (small blind) collected (€0.48)
Seat 3: Fraxasso (big blind) folded before Flop
Seat 4: gas888 folded before Flop (didn't bet)
Seat 5: mashallahh folded before Flop (didn't bet)
Seat 6: diesel197474 folded before Flop (didn't bet)



PokerStars Zoom Hand #258128614209:  Hold'em No Limit (€0.01/€0.02) [ADM ID: M62C63044C87BABT] - 2025/10/15 0:20:10 CET [2025/10/14 18:20:10 ET]
Table 'Sirio' 6-max Seat #1 is the button
Seat 1: caduceus369 (€2.25 in chips) 
Seat 2: Begimon (€7.74 in chips) 
Seat 3: gas888 (€2.59 in chips) 
Seat 4: TheMule1454 (€2.11 in chips) 
Seat 5: father2008 (€2.13 in chips) 
Seat 6: cryyh (€2.46 in chips) 
Begimon: posts small blind €0.01
gas888: posts big blind €0.02
*** HOLE CARDS ***
Dealt to caduceus369 [6d 6c]
TheMule1454: folds 
father2008: raises €0.04 to €0.06
cryyh: folds 
caduceus369: calls €0.06
Begimon: folds 
gas888: folds 
*** FLOP *** [3s 9d Td]
father2008: checks 
caduceus369: checks 
*** TURN *** [3s 9d Td] [Js]
father2008: checks 
caduceus369: checks 
*** RIVER *** [3s 9d Td Js] [8s]
father2008: checks 
caduceus369: checks 
*** SHOW DOWN ***
father2008: shows [7c 7s] (a straight, Seven to Jack)
caduceus369: mucks hand 
father2008 collected €0.15 from pot
*** SUMMARY ***
Total pot €0.15 | Rake €0 
Board [3s 9d Td Js 8s]
Seat 1: caduceus369 (button) mucked [6d 6c]
Seat 2: Begimon (small blind) folded before Flop
Seat 3: gas888 (big blind) folded before Flop
Seat 4: TheMule1454 folded before Flop (didn't bet)
Seat 5: father2008 showed [7c 7s] and won (€0.15) with a straight, Seven to Jack
Seat 6: cryyh folded before Flop (didn't bet)



PokerStars Zoom Hand #258128621221:  Hold'em No Limit (€0.01/€0.02) [ADM ID: M62C63044C87BABT] - 2025/10/15 0:20:45 CET [2025/10/14 18:20:45 ET]
Table 'Sirio' 6-max Seat #1 is the button
Seat 1: Ohhhhyeahhh89 (€0.92 in chips) 
Seat 2: TheMule1454 (€2 in chips) 
Seat 3: father2008 (€2.22 in chips) 
Seat 4: mashallahh (€7.20 in chips) 
Seat 5: caduceus369 (€2.19 in chips) 
Seat 6: CarlaBBruni (€2.97 in chips) 
TheMule1454: posts small blind €0.01
father2008: posts big blind €0.02
*** HOLE CARDS ***
Dealt to caduceus369 [4h 4c]
mashallahh: folds 
caduceus369: folds 
CarlaBBruni: folds 
Ohhhhyeahhh89: folds 
TheMule1454: raises €0.04 to €0.06
father2008: folds 
Uncalled bet (€0.04) returned to TheMule1454
TheMule1454 collected €0.04 from pot
TheMule1454: doesn't show hand 
*** SUMMARY ***
Total pot €0.04 | Rake €0 
Seat 1: Ohhhhyeahhh89 (button) folded before Flop (didn't bet)
Seat 2: TheMule1454 (small blind) collected (€0.04)
Seat 3: father2008 (big blind) folded before Flop
Seat 4: mashallahh folded before Flop (didn't bet)
Seat 5: caduceus369 folded before Flop (didn't bet)
Seat 6: CarlaBBruni folded before Flop (didn't bet)



PokerStars Zoom Hand #258128625564:  Hold'em No Limit (€0.01/€0.02) [ADM ID: M62C63044C87BABT] - 2025/10/15 0:21:05 CET [2025/10/14 18:21:05 ET]
Table 'Sirio' 6-max Seat #1 is the button
Seat 1: diesel197474 (€1.73 in chips) 
Seat 2: ADRIAN0_MEIS (€3.62 in chips) 
Seat 3: 2PaperelaSgubio (€1.99 in chips) 
Seat 4: mashallahh (€7.50 in chips) 
Seat 5: Warterror90 (€6.29 in chips) 
Seat 6: caduceus369 (€2.19 in chips) 
ADRIAN0_MEIS: posts small blind €0.01
2PaperelaSgubio: posts big blind €0.02
*** HOLE CARDS ***
Dealt to caduceus369 [9d 5s]
mashallahh: folds 
Warterror90: folds 
caduceus369: folds 
diesel197474: folds 
ADRIAN0_MEIS: folds 
Uncalled bet (€0.01) returned to 2PaperelaSgubio
2PaperelaSgubio collected €0.02 from pot
2PaperelaSgubio: doesn't show hand 
*** SUMMARY ***
Total pot €0.02 | Rake €0 
Seat 1: diesel197474 (button) folded before Flop (didn't bet)
Seat 2: ADRIAN0_MEIS (small blind) folded before Flop
Seat 3: 2PaperelaSgubio (big blind) collected (€0.02)
Seat 4: mashallahh folded before Flop (didn't bet)
Seat 5: Warterror90 folded before Flop (didn't bet)
Seat 6: caduceus369 folded before Flop (didn't bet)



PokerStars Zoom Hand #258128626850:  Hold'em No Limit (€0.01/€0.02) [ADM ID: M62C63044C87BABT] - 2025/10/15 0:21:12 CET [2025/10/14 18:21:12 ET]
Table 'Sirio' 6-max Seat #1 is the button
Seat 1: Samunho01 (€2.91 in chips) 
Seat 2: meteco79 (€0.93 in chips) 
Seat 3: ADRIAN0_MEIS (€3.61 in chips) 
Seat 4: Warterror90 (€6.29 in chips) 
Seat 5: caduceus369 (€2.19 in chips) 
Seat 6: TheMule1454 (€2.02 in chips) 
meteco79: posts small blind €0.01
ADRIAN0_MEIS: posts big blind €0.02
*** HOLE CARDS ***
Dealt to caduceus369 [3c Js]
Warterror90: folds 
caduceus369: folds 
TheMule1454: folds 
Samunho01: folds 
meteco79: calls €0.01
ADRIAN0_MEIS: checks 
*** FLOP *** [7h 6d Qs]
meteco79: checks 
ADRIAN0_MEIS: checks 
*** TURN *** [7h 6d Qs] [Ks]
meteco79: bets €0.02
ADRIAN0_MEIS: calls €0.02
*** RIVER *** [7h 6d Qs Ks] [6h]
meteco79: bets €0.02
ADRIAN0_MEIS: calls €0.02
*** SHOW DOWN ***
meteco79: shows [Ah Kh] (two pair, Kings and Sixes)
ADRIAN0_MEIS: mucks hand 
meteco79 collected €0.12 from pot
*** SUMMARY ***
Total pot €0.12 | Rake €0 
Board [7h 6d Qs Ks 6h]
Seat 1: Samunho01 (button) folded before Flop (didn't bet)
Seat 2: meteco79 (small blind) showed [Ah Kh] and won (€0.12) with two pair, Kings and Sixes
Seat 3: ADRIAN0_MEIS (big blind) mucked [7d 8h]
Seat 4: Warterror90 folded before Flop (didn't bet)
Seat 5: caduceus369 folded before Flop (didn't bet)
Seat 6: TheMule1454 folded before Flop (didn't bet)



PokerStars Zoom Hand #258128628502:  Hold'em No Limit (€0.01/€0.02) [ADM ID: M62C63044C87BABT] - 2025/10/15 0:21:19 CET [2025/10/14 18:21:19 ET]
Table 'Sirio' 6-max Seat #1 is the button
Seat 1: mashallahh (€7.49 in chips) 
Seat 2: Crock361 (€3.38 in chips) 
Seat 3: caduceus369 (€2.19 in chips) 
Seat 4: This Heat (€2.02 in chips) 
Seat 5: bv0360 (€0.80 in chips) 
Seat 6: Diabolik0862 (€1.55 in chips) 
Crock361: posts small blind €0.01
caduceus369: posts big blind €0.02
*** HOLE CARDS ***
Dealt to caduceus369 [Kh 2s]
This Heat: raises €0.04 to €0.06
bv0360: calls €0.06
Diabolik0862: folds 
mashallahh: folds 
Crock361: folds 
caduceus369: folds 
*** FLOP *** [Jh 5c 6c]
This Heat: bets €0.08
bv0360: calls €0.08
*** TURN *** [Jh 5c 6c] [3c]
This Heat: bets €0.15
bv0360: folds 
Uncalled bet (€0.15) returned to This Heat
This Heat collected €0.30 from pot
This Heat: doesn't show hand 
*** SUMMARY ***
Total pot €0.31 | Rake €0.01 
Board [Jh 5c 6c 3c]
Seat 1: mashallahh (button) folded before Flop (didn't bet)
Seat 2: Crock361 (small blind) folded before Flop
Seat 3: caduceus369 (big blind) folded before Flop
Seat 4: This Heat collected (€0.30)
Seat 5: bv0360 folded on the Turn
Seat 6: Diabolik0862 folded before Flop (didn't bet)



PokerStars Zoom Hand #258128631799:  Hold'em No Limit (€0.01/€0.02) [ADM ID: M62C63044C87BABT] - 2025/10/15 0:21:36 CET [2025/10/14 18:21:36 ET]
Table 'Sirio' 6-max Seat #1 is the button
Seat 1: father2008 (€2.06 in chips) 
Seat 2: gas888 (€11.79 in chips) 
Seat 3: MARKNO73 (€0.72 in chips) 
Seat 4: caduceus369 (€2.17 in chips) 
Seat 5: TheMule1454 (€2.33 in chips) 
Seat 6: Fraxasso (€4.11 in chips) 
gas888: posts small blind €0.01
MARKNO73: posts big blind €0.02
*** HOLE CARDS ***
Dealt to caduceus369 [3h Jh]
caduceus369: folds 
TheMule1454: folds 
Fraxasso: folds 
father2008: raises €0.04 to €0.06
gas888: folds 
MARKNO73: calls €0.04
*** FLOP *** [Tc Jc 8h]
MARKNO73: bets €0.04
father2008: calls €0.04
*** TURN *** [Tc Jc 8h] [3d]
MARKNO73: bets €0.06
father2008: calls €0.06
*** RIVER *** [Tc Jc 8h 3d] [Ah]
MARKNO73: bets €0.06
father2008: calls €0.06
*** SHOW DOWN ***
MARKNO73: shows [Jd As] (two pair, Aces and Jacks)
father2008: mucks hand 
MARKNO73 collected €0.43 from pot
*** SUMMARY ***
Total pot €0.45 | Rake €0.02 
Board [Tc Jc 8h 3d Ah]
Seat 1: father2008 (button) mucked [9d 9c]
Seat 2: gas888 (small blind) folded before Flop
Seat 3: MARKNO73 (big blind) showed [Jd As] and won (€0.43) with two pair, Aces and Jacks
Seat 4: caduceus369 folded before Flop (didn't bet)
Seat 5: TheMule1454 folded before Flop (didn't bet)
Seat 6: Fraxasso folded before Flop (didn't bet)



PokerStars Zoom Hand #258128634275:  Hold'em No Limit (€0.01/€0.02) [ADM ID: M62C63044C87BABT] - 2025/10/15 0:21:48 CET [2025/10/14 18:21:48 ET]
Table 'Sirio' 6-max Seat #1 is the button
Seat 1: gas888 (€4.09 in chips) 
Seat 2: caduceus369 (€2.17 in chips) 
Seat 3: Ohhhhyeahhh89 (€0.85 in chips) 
Seat 4: CarlaBBruni (€2.94 in chips) 
Seat 5: Crock361 (€1.97 in chips) 
Seat 6: Begimon (€7.66 in chips) 
caduceus369: posts small blind €0.01
Ohhhhyeahhh89: posts big blind €0.02
*** HOLE CARDS ***
Dealt to caduceus369 [As 3c]
CarlaBBruni: folds 
Crock361: raises €0.04 to €0.06
Begimon: folds 
gas888: folds 
caduceus369: folds 
Ohhhhyeahhh89: calls €0.04
*** FLOP *** [6d Ad 2h]
Ohhhhyeahhh89: checks 
Crock361: bets €0.07
Ohhhhyeahhh89: folds 
Uncalled bet (€0.07) returned to Crock361
Crock361 collected €0.13 from pot
Crock361: doesn't show hand 
*** SUMMARY ***
Total pot €0.13 | Rake €0 
Board [6d Ad 2h]
Seat 1: gas888 (button) folded before Flop (didn't bet)
Seat 2: caduceus369 (small blind) folded before Flop
Seat 3: Ohhhhyeahhh89 (big blind) folded on the Flop
Seat 4: CarlaBBruni folded before Flop (didn't bet)
Seat 5: Crock361 collected (€0.13)
Seat 6: Begimon folded before Flop (didn't bet)



PokerStars Zoom Hand #258128637934:  Hold'em No Limit (€0.01/€0.02) [ADM ID: M62C63044C87BABT] - 2025/10/15 0:22:06 CET [2025/10/14 18:22:06 ET]
Table 'Sirio' 6-max Seat #1 is the button
Seat 1: caduceus369 (€2.16 in chips) 
Seat 2: diesel197474 (€1.71 in chips) 
Seat 3: TheMule1454 (€2.12 in chips) 
Seat 4: Fraxasso (€4.14 in chips) 
Seat 5: Agnese84 (€1.63 in chips) 
Seat 6: gas888 (€2.59 in chips) 
diesel197474: posts small blind €0.01
TheMule1454: posts big blind €0.02
*** HOLE CARDS ***
Dealt to caduceus369 [Js 2c]
Fraxasso: folds 
Agnese84: raises €0.05 to €0.07
gas888: folds 
caduceus369: folds 
diesel197474: calls €0.06
TheMule1454: calls €0.05
*** FLOP *** [Td 4h Ad]
diesel197474: checks 
TheMule1454: checks 
Agnese84: bets €0.20
diesel197474: folds 
TheMule1454: folds 
Uncalled bet (€0.20) returned to Agnese84
Agnese84 collected €0.20 from pot
Agnese84: doesn't show hand 
*** SUMMARY ***
Total pot €0.21 | Rake €0.01 
Board [Td 4h Ad]
Seat 1: caduceus369 (button) folded before Flop (didn't bet)
Seat 2: diesel197474 (small blind) folded on the Flop
Seat 3: TheMule1454 (big blind) folded on the Flop
Seat 4: Fraxasso folded before Flop (didn't bet)
Seat 5: Agnese84 collected (€0.20)
Seat 6: gas888 folded before Flop (didn't bet)



PokerStars Zoom Hand #258128642393:  Hold'em No Limit (€0.01/€0.02) [ADM ID: M62C63044C87BABT] - 2025/10/15 0:22:27 CET [2025/10/14 18:22:27 ET]
Table 'Sirio' 6-max Seat #1 is the button
Seat 1: Fraxasso (€4.78 in chips) 
Seat 2: mashallahh (€5.20 in chips) 
Seat 3: 2PaperelaSgubio (€2.08 in chips) 
Seat 4: Crock361 (€2.04 in chips) 
Seat 5: caduceus369 (€2.16 in chips) 
Seat 6: TheMule1454 (€1.98 in chips) 
mashallahh: posts small blind €0.01
2PaperelaSgubio: posts big blind €0.02
*** HOLE CARDS ***
Dealt to caduceus369 [8c Jc]
Crock361: raises €0.04 to €0.06
caduceus369: folds 
TheMule1454: folds 
Fraxasso: folds 
mashallahh: raises €0.12 to €0.18
2PaperelaSgubio: folds 
Crock361: calls €0.12
*** FLOP *** [7d Tc 2c]
mashallahh: bets €0.28
Crock361: folds 
Uncalled bet (€0.28) returned to mashallahh
mashallahh collected €0.36 from pot
mashallahh: doesn't show hand 
*** SUMMARY ***
Total pot €0.38 | Rake €0.02 
Board [7d Tc 2c]
Seat 1: Fraxasso (button) folded before Flop (didn't bet)
Seat 2: mashallahh (small blind) collected (€0.36)
Seat 3: 2PaperelaSgubio (big blind) folded before Flop
Seat 4: Crock361 folded on the Flop
Seat 5: caduceus369 folded before Flop (didn't bet)
Seat 6: TheMule1454 folded before Flop (didn't bet)



PokerStars Zoom Hand #258128648256:  Hold'em No Limit (€0.01/€0.02) [ADM ID: M62C63044C87BABT] - 2025/10/15 0:22:55 CET [2025/10/14 18:22:55 ET]
Table 'Sirio' 6-max Seat #1 is the button
Seat 1: Fraxasso (€3.62 in chips) 
Seat 2: caduceus369 (€2.14 in chips) 
Seat 3: Ohhhhyeahhh89 (€0.77 in chips) 
Seat 4: aurelios2 (€14.16 in chips) 
Seat 5: 2PaperelaSgubio (€2.05 in chips) 
Seat 6: Warterror90 (€3.44 in chips) 
caduceus369: posts small blind €0.01
Ohhhhyeahhh89: posts big blind €0.02
*** HOLE CARDS ***
Dealt to caduceus369 [Td 3h]
aurelios2: folds 
2PaperelaSgubio: folds 
Warterror90: folds 
Fraxasso: folds 
caduceus369: folds 
Uncalled bet (€0.01) returned to Ohhhhyeahhh89
Ohhhhyeahhh89 collected €0.02 from pot
Ohhhhyeahhh89: doesn't show hand 
*** SUMMARY ***
Total pot €0.02 | Rake €0 
Seat 1: Fraxasso (button) folded before Flop (didn't bet)
Seat 2: caduceus369 (small blind) folded before Flop
Seat 3: Ohhhhyeahhh89 (big blind) collected (€0.02)
Seat 4: aurelios2 folded before Flop (didn't bet)
Seat 5: 2PaperelaSgubio folded before Flop (didn't bet)
Seat 6: Warterror90 folded before Flop (didn't bet)



PokerStars Zoom Hand #258128641093:  Hold'em No Limit (€0.01/€0.02) [ADM ID: M62C63044C87BABT] - 2025/10/15 0:22:21 CET [2025/10/14 18:22:21 ET]
Table 'Sirio' 6-max Seat #1 is the button
Seat 1: 2PaperelaSgubio (€2.08 in chips) 
Seat 2: CIKO71131 (€0.74 in chips) 
Seat 3: gas888 (€1.38 in chips) 
Seat 4: teicano98 (€1.54 in chips) 
Seat 5: TheMule1454 (€1.99 in chips) 
Seat 6: caduceus369 (€2.16 in chips) 
CIKO71131: posts small blind €0.01
gas888: posts big blind €0.02
*** HOLE CARDS ***
Dealt to caduceus369 [Qs 5s]
teicano98: folds 
TheMule1454: folds 
caduceus369: folds 
2PaperelaSgubio: folds 
CIKO71131: calls €0.01
gas888: checks 
*** FLOP *** [4d Tc 9s]
CIKO71131: checks 
gas888: checks 
*** TURN *** [4d Tc 9s] [6s]
CIKO71131: checks 
gas888: bets €0.02
CIKO71131: calls €0.02
*** RIVER *** [4d Tc 9s 6s] [5c]
CIKO71131: checks 
gas888: checks 
*** SHOW DOWN ***
CIKO71131: shows [4s 8h] (a pair of Fours)
gas888: shows [7c 6d] (a pair of Sixes)
gas888 collected €0.08 from pot
*** SUMMARY ***
Total pot €0.08 | Rake €0 
Board [4d Tc 9s 6s 5c]
Seat 1: 2PaperelaSgubio (button) folded before Flop (didn't bet)
Seat 2: CIKO71131 (small blind) showed [4s 8h] and lost with a pair of Fours
Seat 3: gas888 (big blind) showed [7c 6d] and won (€0.08) with a pair of Sixes
Seat 4: teicano98 folded before Flop (didn't bet)
Seat 5: TheMule1454 folded before Flop (didn't bet)
Seat 6: caduceus369 folded before Flop (didn't bet)



PokerStars Zoom Hand #258128632936:  Hold'em No Limit (€0.01/€0.02) [ADM ID: M62C63044C87BABT] - 2025/10/15 0:21:41 CET [2025/10/14 18:21:41 ET]
Table 'Sirio' 6-max Seat #1 is the button
Seat 1: Freddy15081988 (€0.81 in chips) 
Seat 2: Begimon (€7.67 in chips) 
Seat 3: Fraxasso (€4.80 in chips) 
Seat 4: caduceus369 (€2.17 in chips) 
Seat 5: teicano98 (€1.22 in chips) 
Seat 6: toscano31 (€1.24 in chips) 
Begimon: posts small blind €0.01
Fraxasso: posts big blind €0.02
*** HOLE CARDS ***
Dealt to caduceus369 [9h Tc]
caduceus369: folds 
teicano98: folds 
toscano31: calls €0.02
Freddy15081988: calls €0.02
Begimon: folds 
Fraxasso: checks 
*** FLOP *** [7d 5c Jc]
Fraxasso: checks 
toscano31: bets €0.07
Freddy15081988: calls €0.07
Fraxasso: folds 
*** TURN *** [7d 5c Jc] [5d]
toscano31: bets €0.10
Freddy15081988: calls €0.10
*** RIVER *** [7d 5c Jc 5d] [2h]
toscano31: checks 
Freddy15081988: bets €0.20
toscano31: folds 
Uncalled bet (€0.20) returned to Freddy15081988
Freddy15081988 collected €0.39 from pot
Freddy15081988: doesn't show hand 
*** SUMMARY ***
Total pot €0.41 | Rake €0.02 
Board [7d 5c Jc 5d 2h]
Seat 1: Freddy15081988 (button) collected (€0.39)
Seat 2: Begimon (small blind) folded before Flop
Seat 3: Fraxasso (big blind) folded on the Flop
Seat 4: caduceus369 folded before Flop (didn't bet)
Seat 5: teicano98 folded before Flop (didn't bet)
Seat 6: toscano31 folded on the River



PokerStars Zoom Hand #258128644375:  Hold'em No Limit (€0.01/€0.02) [ADM ID: M62C63044C87BABT] - 2025/10/15 0:22:37 CET [2025/10/14 18:22:37 ET]
Table 'Sirio' 6-max Seat #1 is the button
Seat 1: gas888 (€11.76 in chips) 
Seat 2: teicano98 (€1.20 in chips) 
Seat 3: caduceus369 (€2.16 in chips) 
Seat 4: 2PaperelaSgubio (€2.65 in chips) 
Seat 5: aurelios2 (€14.15 in chips) 
Seat 6: Crock361 (€3.35 in chips) 
teicano98: posts small blind €0.01
caduceus369: posts big blind €0.02
*** HOLE CARDS ***
Dealt to caduceus369 [7d 8h]
2PaperelaSgubio: folds 
aurelios2: folds 
Crock361: raises €0.04 to €0.06
gas888: calls €0.06
teicano98: folds 
caduceus369: folds 
*** FLOP *** [Ad 4c 9c]
Crock361: checks 
gas888: bets €0.05
Crock361: calls €0.05
*** TURN *** [Ad 4c 9c] [6c]
Crock361: checks 
gas888: checks 
*** RIVER *** [Ad 4c 9c 6c] [As]
Crock361: bets €0.08
gas888: calls €0.08
*** SHOW DOWN ***
Crock361: shows [Ah Ts] (three of a kind, Aces)
gas888: mucks hand 
Crock361 collected €0.39 from pot
*** SUMMARY ***
Total pot €0.41 | Rake €0.02 
Board [Ad 4c 9c 6c As]
Seat 1: gas888 (button) mucked [5h 5c]
Seat 2: teicano98 (small blind) folded before Flop
Seat 3: caduceus369 (big blind) folded before Flop
Seat 4: 2PaperelaSgubio folded before Flop (didn't bet)
Seat 5: aurelios2 folded before Flop (didn't bet)
Seat 6: Crock361 showed [Ah Ts] and won (€0.39) with three of a kind, Aces



PokerStars Zoom Hand #258128651401:  Hold'em No Limit (€0.01/€0.02) [ADM ID: M62C63044C87BABT] - 2025/10/15 0:23:11 CET [2025/10/14 18:23:11 ET]
Table 'Sirio' 6-max Seat #1 is the button
Seat 1: 2PaperelaSgubio (€2.05 in chips) 
Seat 2: Warterror90 (€6.01 in chips) 
Seat 3: Fraxasso (€3.62 in chips) 
Seat 4: Rrrr322 (€1.58 in chips) 
Seat 5: talpa890 (€1.80 in chips) 
Seat 6: caduceus369 (€2.13 in chips) 
Warterror90: posts small blind €0.01
Fraxasso: posts big blind €0.02
*** HOLE CARDS ***
Dealt to caduceus369 [7d 4h]
Rrrr322: calls €0.02
talpa890: folds 
caduceus369: folds 
2PaperelaSgubio: folds 
Warterror90: raises €0.04 to €0.06
Fraxasso: folds 
Rrrr322: calls €0.04
*** FLOP *** [Tc 4d As]
Warterror90: bets €0.06
Rrrr322: folds 
Uncalled bet (€0.06) returned to Warterror90
Warterror90 collected €0.14 from pot
Warterror90: doesn't show hand 
*** SUMMARY ***
Total pot €0.14 | Rake €0 
Board [Tc 4d As]
Seat 1: 2PaperelaSgubio (button) folded before Flop (didn't bet)
Seat 2: Warterror90 (small blind) collected (€0.14)
Seat 3: Fraxasso (big blind) folded before Flop
Seat 4: Rrrr322 folded on the Flop
Seat 5: talpa890 folded before Flop (didn't bet)
Seat 6: caduceus369 folded before Flop (didn't bet)



PokerStars Zoom Hand #258128649617:  Hold'em No Limit (€0.01/€0.02) [ADM ID: M62C63044C87BABT] - 2025/10/15 0:23:02 CET [2025/10/14 18:23:02 ET]
Table 'Sirio' 6-max Seat #1 is the button
Seat 1: caduceus369 (€2.13 in chips) 
Seat 2: TheMule1454 (€2.61 in chips) 
Seat 3: fccmp (€0.90 in chips) 
Seat 4: Fraxasso (€3.62 in chips) 
Seat 5: colosso2022 (€7.25 in chips) 
Seat 6: teicano98 (€1.19 in chips) 
TheMule1454: posts small blind €0.01
fccmp: posts big blind €0.02
*** HOLE CARDS ***
Dealt to caduceus369 [4h 3h]
Fraxasso: folds 
colosso2022: calls €0.02
teicano98: raises €0.07 to €0.09
caduceus369: folds 
TheMule1454: folds 
fccmp: folds 
colosso2022: calls €0.07
*** FLOP *** [Jh Ac 9s]
colosso2022: bets €0.02
teicano98: folds 
Uncalled bet (€0.02) returned to colosso2022
colosso2022 collected €0.20 from pot
colosso2022: doesn't show hand 
*** SUMMARY ***
Total pot €0.21 | Rake €0.01 
Board [Jh Ac 9s]
Seat 1: caduceus369 (button) folded before Flop (didn't bet)
Seat 2: TheMule1454 (small blind) folded before Flop
Seat 3: fccmp (big blind) folded before Flop
Seat 4: Fraxasso folded before Flop (didn't bet)
Seat 5: colosso2022 collected (€0.20)
Seat 6: teicano98 folded on the Flop



PokerStars Zoom Hand #258128656742:  Hold'em No Limit (€0.01/€0.02) [ADM ID: M62C63044C87BABT] - 2025/10/15 0:23:36 CET [2025/10/14 18:23:36 ET]
Table 'Sirio' 6-max Seat #1 is the button
Seat 1: Warterror90 (€3.51 in chips) 
Seat 2: teicano98 (€1.52 in chips) 
Seat 3: caduceus369 (€2.13 in chips) 
Seat 4: TheMule1454 (€2.05 in chips) 
Seat 5: Fraxasso (€5.05 in chips) 
Seat 6: 2PaperelaSgubio (€2.62 in chips) 
teicano98: posts small blind €0.01
caduceus369: posts big blind €0.02
*** HOLE CARDS ***
Dealt to caduceus369 [5d 5c]
TheMule1454: folds 
Fraxasso: folds 
2PaperelaSgubio: folds 
Warterror90: folds 
teicano98: folds 
Uncalled bet (€0.01) returned to caduceus369
caduceus369 collected €0.02 from pot
caduceus369: doesn't show hand 
*** SUMMARY ***
Total pot €0.02 | Rake €0 
Seat 1: Warterror90 (button) folded before Flop (didn't bet)
Seat 2: teicano98 (small blind) folded before Flop
Seat 3: caduceus369 (big blind) collected (€0.02)
Seat 4: TheMule1454 folded before Flop (didn't bet)
Seat 5: Fraxasso folded before Flop (didn't bet)
Seat 6: 2PaperelaSgubio folded before Flop (didn't bet)



PokerStars Zoom Hand #258128655455:  Hold'em No Limit (€0.01/€0.02) [ADM ID: M62C63044C87BABT] - 2025/10/15 0:23:30 CET [2025/10/14 18:23:30 ET]
Table 'Sirio' 6-max Seat #1 is the button
Seat 1: fccmp (€0.88 in chips) 
Seat 2: Agnese84 (€2 in chips) 
Seat 3: TheMule1454 (€2.60 in chips) 
Seat 4: caduceus369 (€2.13 in chips) 
Seat 5: Fraxasso (€3.60 in chips) 
Seat 6: BiscottinoXXL (€2.02 in chips) 
Agnese84: posts small blind €0.01
TheMule1454: posts big blind €0.02
*** HOLE CARDS ***
Dealt to caduceus369 [4s 7c]
caduceus369: folds 
Fraxasso: raises €0.02 to €0.04
BiscottinoXXL: calls €0.04
fccmp: folds 
Agnese84: folds 
TheMule1454: calls €0.02
*** FLOP *** [Qs 2c Kc]
TheMule1454: checks 
Fraxasso: checks 
BiscottinoXXL: bets €0.06
TheMule1454: calls €0.06
Fraxasso: folds 
*** TURN *** [Qs 2c Kc] [7h]
TheMule1454: checks 
BiscottinoXXL: bets €0.12
TheMule1454: folds 
Uncalled bet (€0.12) returned to BiscottinoXXL
BiscottinoXXL collected €0.24 from pot
BiscottinoXXL: doesn't show hand 
*** SUMMARY ***
Total pot €0.25 | Rake €0.01 
Board [Qs 2c Kc 7h]
Seat 1: fccmp (button) folded before Flop (didn't bet)
Seat 2: Agnese84 (small blind) folded before Flop
Seat 3: TheMule1454 (big blind) folded on the Turn
Seat 4: caduceus369 folded before Flop (didn't bet)
Seat 5: Fraxasso folded on the Flop
Seat 6: BiscottinoXXL collected (€0.24)



PokerStars Zoom Hand #258128663208:  Hold'em No Limit (€0.01/€0.02) [ADM ID: M62C63044C87BABT] - 2025/10/15 0:24:07 CET [2025/10/14 18:24:07 ET]
Table 'Sirio' 6-max Seat #1 is the button
Seat 1: caduceus369 (€2.14 in chips) 
Seat 2: father2008 (€2 in chips) 
Seat 3: ilteatro131 (€2 in chips) 
Seat 4: teicano98 (€1.10 in chips) 
Seat 5: colosso2022 (€7.36 in chips) 
Seat 6: Fraxasso (€3.56 in chips) 
father2008: posts small blind €0.01
ilteatro131: posts big blind €0.02
*** HOLE CARDS ***
Dealt to caduceus369 [9c 3c]
teicano98: folds 
colosso2022: raises €0.02 to €0.04
Fraxasso: folds 
caduceus369: folds 
father2008: folds 
ilteatro131: calls €0.02
*** FLOP *** [8s Ah Ts]
ilteatro131: checks 
colosso2022: bets €0.09
ilteatro131: folds 
Uncalled bet (€0.09) returned to colosso2022
colosso2022 collected €0.09 from pot
colosso2022: doesn't show hand 
*** SUMMARY ***
Total pot €0.09 | Rake €0 
Board [8s Ah Ts]
Seat 1: caduceus369 (button) folded before Flop (didn't bet)
Seat 2: father2008 (small blind) folded before Flop
Seat 3: ilteatro131 (big blind) folded on the Flop
Seat 4: teicano98 folded before Flop (didn't bet)
Seat 5: colosso2022 collected (€0.09)
Seat 6: Fraxasso folded before Flop (didn't bet)



PokerStars Zoom Hand #258128661774:  Hold'em No Limit (€0.01/€0.02) [ADM ID: M62C63044C87BABT] - 2025/10/15 0:24:00 CET [2025/10/14 18:24:00 ET]
Table 'Sirio' 6-max Seat #1 is the button
Seat 1: maury999999 (€5.08 in chips) 
Seat 2: aurelios2 (€14.04 in chips) 
Seat 3: TheMule1454 (€1.76 in chips) 
Seat 4: caduceus369 (€2.14 in chips) 
Seat 5: gas888 (€11.56 in chips) 
Seat 6: father2008 (€2 in chips) 
aurelios2: posts small blind €0.01
TheMule1454: posts big blind €0.02
*** HOLE CARDS ***
Dealt to caduceus369 [6c Kc]
caduceus369: folds 
gas888: folds 
father2008: folds 
maury999999: folds 
aurelios2: calls €0.01
TheMule1454: raises €0.06 to €0.08
aurelios2: calls €0.06
*** FLOP *** [2h 3d 5s]
aurelios2: checks 
TheMule1454: bets €0.08
aurelios2: calls €0.08
*** TURN *** [2h 3d 5s] [4c]
aurelios2: checks 
TheMule1454: checks 
*** RIVER *** [2h 3d 5s 4c] [3h]
aurelios2: checks 
TheMule1454: checks 
*** SHOW DOWN ***
aurelios2: shows [Ts 9d] (a pair of Threes)
TheMule1454: shows [7h 7s] (two pair, Sevens and Threes)
TheMule1454 collected €0.31 from pot
*** SUMMARY ***
Total pot €0.32 | Rake €0.01 
Board [2h 3d 5s 4c 3h]
Seat 1: maury999999 (button) folded before Flop (didn't bet)
Seat 2: aurelios2 (small blind) showed [Ts 9d] and lost with a pair of Threes
Seat 3: TheMule1454 (big blind) showed [7h 7s] and won (€0.31) with two pair, Sevens and Threes
Seat 4: caduceus369 folded before Flop (didn't bet)
Seat 5: gas888 folded before Flop (didn't bet)
Seat 6: father2008 folded before Flop (didn't bet)



PokerStars Zoom Hand #258128665252:  Hold'em No Limit (€0.01/€0.02) [ADM ID: M62C63044C87BABT] - 2025/10/15 0:24:17 CET [2025/10/14 18:24:17 ET]
Table 'Sirio' 6-max Seat #1 is the button
Seat 1: gas888 (€4.04 in chips) 
Seat 2: Fraxasso (€3.56 in chips) 
Seat 3: teicano98 (€1.10 in chips) 
Seat 4: Samunho01 (€2.73 in chips) 
Seat 5: caduceus369 (€2.14 in chips) 
Seat 6: Diabolik0862 (€1.32 in chips) 
Fraxasso: posts small blind €0.01
teicano98: posts big blind €0.02
*** HOLE CARDS ***
Dealt to caduceus369 [Jh Ks]
Samunho01 has timed out
Samunho01: folds 
caduceus369: raises €0.04 to €0.06
Diabolik0862: calls €0.06
gas888: folds 
Fraxasso: folds 
teicano98: calls €0.04
*** FLOP *** [Jc 3s 2d]
teicano98: checks 
caduceus369: bets €0.06
Diabolik0862: raises €0.30 to €0.36
teicano98: folds 
caduceus369: calls €0.30
*** TURN *** [Jc 3s 2d] [Jd]
caduceus369: checks 
Diabolik0862: bets €0.90 and is all-in
caduceus369: calls €0.90
*** RIVER *** [Jc 3s 2d Jd] [Td]
*** SHOW DOWN ***
caduceus369: shows [Jh Ks] (three of a kind, Jacks)
Diabolik0862: shows [Ad Ac] (two pair, Aces and Jacks)
caduceus369 collected €2.57 from pot
*** SUMMARY ***
Total pot €2.71 | Rake €0.14 
Board [Jc 3s 2d Jd Td]
Seat 1: gas888 (button) folded before Flop (didn't bet)
Seat 2: Fraxasso (small blind) folded before Flop
Seat 3: teicano98 (big blind) folded on the Flop
Seat 4: Samunho01 folded before Flop (didn't bet)
Seat 5: caduceus369 showed [Jh Ks] and won (€2.57) with three of a kind, Jacks
Seat 6: Diabolik0862 showed [Ad Ac] and lost with two pair, Aces and Jacks



PokerStars Zoom Hand #258128681600:  Hold'em No Limit (€0.01/€0.02) [ADM ID: M62C63044C87BABT] - 2025/10/15 0:25:36 CET [2025/10/14 18:25:36 ET]
Table 'Sirio' 6-max Seat #1 is the button
Seat 1: 2PaperelaSgubio (€2.10 in chips) 
Seat 2: caduceus369 (€3.39 in chips) 
Seat 3: meteco79 (€0.51 in chips) 
Seat 4: fccmp (€1.83 in chips) 
Seat 5: CarlaBBruni (€2.81 in chips) 
Seat 6: molgi (€2 in chips) 
caduceus369: posts small blind €0.01
meteco79: posts big blind €0.02
*** HOLE CARDS ***
Dealt to caduceus369 [4d 9s]
fccmp: folds 
CarlaBBruni: folds 
molgi: calls €0.02
2PaperelaSgubio: folds 
caduceus369: folds 
meteco79: checks 
*** FLOP *** [6c Ad Jc]
meteco79: checks 
molgi: checks 
*** TURN *** [6c Ad Jc] [Kc]
meteco79: checks 
molgi: bets €0.02
meteco79: calls €0.02
*** RIVER *** [6c Ad Jc Kc] [3s]
meteco79: checks 
molgi: bets €0.09
meteco79: calls €0.09
*** SHOW DOWN ***
molgi: shows [8h Td] (high card Ace)
meteco79: shows [Ks 5s] (a pair of Kings)
meteco79 collected €0.26 from pot
*** SUMMARY ***
Total pot €0.27 | Rake €0.01 
Board [6c Ad Jc Kc 3s]
Seat 1: 2PaperelaSgubio (button) folded before Flop (didn't bet)
Seat 2: caduceus369 (small blind) folded before Flop
Seat 3: meteco79 (big blind) showed [Ks 5s] and won (€0.26) with a pair of Kings
Seat 4: fccmp folded before Flop (didn't bet)
Seat 5: CarlaBBruni folded before Flop (didn't bet)
Seat 6: molgi showed [8h Td] and lost with high card Ace



PokerStars Zoom Hand #258128691512:  Hold'em No Limit (€0.01/€0.02) [ADM ID: M62C63044C87BABT] - 2025/10/15 0:26:23 CET [2025/10/14 18:26:23 ET]
Table 'Sirio' 6-max Seat #1 is the button
Seat 1: mashallahh (€3.93 in chips) 
Seat 2: danielekite (€3.13 in chips) 
Seat 3: gas888 (€11.56 in chips) 
Seat 4: ADRIAN0_MEIS (€3.77 in chips) 
Seat 5: Crock361 (€3.24 in chips) 
Seat 6: caduceus369 (€3.36 in chips) 
danielekite: posts small blind €0.01
gas888: posts big blind €0.02
*** HOLE CARDS ***
Dealt to caduceus369 [Ks 9h]
ADRIAN0_MEIS: raises €0.04 to €0.06
Crock361: folds 
caduceus369: folds 
mashallahh: folds 
danielekite: calls €0.05
gas888: folds 
*** FLOP *** [Kh 4h 9d]
danielekite: bets €0.40
ADRIAN0_MEIS: folds 
Uncalled bet (€0.40) returned to danielekite
danielekite collected €0.14 from pot
danielekite: doesn't show hand 
*** SUMMARY ***
Total pot €0.14 | Rake €0 
Board [Kh 4h 9d]
Seat 1: mashallahh (button) folded before Flop (didn't bet)
Seat 2: danielekite (small blind) collected (€0.14)
Seat 3: gas888 (big blind) folded before Flop
Seat 4: ADRIAN0_MEIS folded on the Flop
Seat 5: Crock361 folded before Flop (didn't bet)
Seat 6: caduceus369 folded before Flop (didn't bet)



PokerStars Zoom Hand #258128693328:  Hold'em No Limit (€0.01/€0.02) [ADM ID: M62C63044C87BABT] - 2025/10/15 0:26:32 CET [2025/10/14 18:26:32 ET]
Table 'Sirio' 6-max Seat #1 is the button
Seat 1: gas888 (€4.02 in chips) 
Seat 2: Crock361 (€3.24 in chips) 
Seat 3: TheMule1454 (€3.13 in chips) 
Seat 4: 2PaperelaSgubio (€2.68 in chips) 
Seat 5: caduceus369 (€3.36 in chips) 
Seat 6: This Heat (€2.14 in chips) 
Crock361: posts small blind €0.01
TheMule1454: posts big blind €0.02
*** HOLE CARDS ***
Dealt to caduceus369 [7d Jd]
2PaperelaSgubio: folds 
caduceus369: folds 
This Heat: raises €0.04 to €0.06
gas888: folds 
Crock361: folds 
TheMule1454: folds 
Uncalled bet (€0.04) returned to This Heat
This Heat collected €0.05 from pot
This Heat: doesn't show hand 
*** SUMMARY ***
Total pot €0.05 | Rake €0 
Seat 1: gas888 (button) folded before Flop (didn't bet)
Seat 2: Crock361 (small blind) folded before Flop
Seat 3: TheMule1454 (big blind) folded before Flop
Seat 4: 2PaperelaSgubio folded before Flop (didn't bet)
Seat 5: caduceus369 folded before Flop (didn't bet)
Seat 6: This Heat collected (€0.05)



PokerStars Zoom Hand #258128684522:  Hold'em No Limit (€0.01/€0.02) [ADM ID: M62C63044C87BABT] - 2025/10/15 0:25:50 CET [2025/10/14 18:25:50 ET]
Table 'Sirio' 6-max Seat #1 is the button
Seat 1: maury999999 (€3.76 in chips) 
Seat 2: gas888 (€4.05 in chips) 
Seat 3: caduceus369 (€3.38 in chips) 
Seat 4: danielekite (€3.10 in chips) 
Seat 5: fccmp (€1.82 in chips) 
Seat 6: Crock361 (€2.38 in chips) 
gas888: posts small blind €0.01
caduceus369: posts big blind €0.02
*** HOLE CARDS ***
Dealt to caduceus369 [Th 6h]
danielekite: folds 
fccmp: calls €0.02
Crock361 has timed out
Crock361: folds 
maury999999: raises €0.06 to €0.08
gas888: folds 
caduceus369: folds 
fccmp: calls €0.06
*** FLOP *** [As Qc 6c]
fccmp: checks 
maury999999: bets €0.06
fccmp: calls €0.06
*** TURN *** [As Qc 6c] [7c]
fccmp: checks 
maury999999: bets €0.20
fccmp: raises €1.48 to €1.68 and is all-in
maury999999: calls €1.48
*** RIVER *** [As Qc 6c 7c] [9c]
*** SHOW DOWN ***
fccmp: shows [8h Ah] (a pair of Aces)
maury999999: shows [Jc Tc] (a flush, Queen high)
maury999999 collected €3.47 from pot
*** SUMMARY ***
Total pot €3.67 | Rake €0.20 
Board [As Qc 6c 7c 9c]
Seat 1: maury999999 (button) showed [Jc Tc] and won (€3.47) with a flush, Queen high
Seat 2: gas888 (small blind) folded before Flop
Seat 3: caduceus369 (big blind) folded before Flop
Seat 4: danielekite folded before Flop (didn't bet)
Seat 5: fccmp showed [8h Ah] and lost with a pair of Aces
Seat 6: Crock361 folded before Flop (didn't bet)



PokerStars Zoom Hand #258128696500:  Hold'em No Limit (€0.01/€0.02) [ADM ID: M62C63044C87BABT] - 2025/10/15 0:26:47 CET [2025/10/14 18:26:47 ET]
Table 'Sirio' 6-max Seat #1 is the button
Seat 1: mashallahh (€7.46 in chips) 
Seat 2: caduceus369 (€3.36 in chips) 
Seat 3: Fraxasso (€3.54 in chips) 
Seat 4: Crock361 (€1.83 in chips) 
Seat 5: danielekite (€3.21 in chips) 
Seat 6: aurelios2 (€13.15 in chips) 
caduceus369: posts small blind €0.01
Fraxasso: posts big blind €0.02
*** HOLE CARDS ***
Dealt to caduceus369 [Ad 6d]
Crock361: folds 
danielekite: raises €0.04 to €0.06
aurelios2: raises €0.08 to €0.14
mashallahh: folds 
caduceus369: folds 
Fraxasso: folds 
danielekite: calls €0.08
*** FLOP *** [Jc 8d Ac]
danielekite: checks 
aurelios2: bets €0.20
danielekite: folds 
Uncalled bet (€0.20) returned to aurelios2
aurelios2 collected €0.30 from pot
aurelios2: doesn't show hand 
*** SUMMARY ***
Total pot €0.31 | Rake €0.01 
Board [Jc 8d Ac]
Seat 1: mashallahh (button) folded before Flop (didn't bet)
Seat 2: caduceus369 (small blind) folded before Flop
Seat 3: Fraxasso (big blind) folded before Flop
Seat 4: Crock361 folded before Flop (didn't bet)
Seat 5: danielekite folded on the Flop
Seat 6: aurelios2 collected (€0.30)



PokerStars Zoom Hand #258128699043:  Hold'em No Limit (€0.01/€0.02) [ADM ID: M62C63044C87BABT] - 2025/10/15 0:26:59 CET [2025/10/14 18:26:59 ET]
Table 'Sirio' 6-max Seat #1 is the button
Seat 1: 2PaperelaSgubio (€2.67 in chips) 
Seat 2: Crock361 (€1.83 in chips) 
Seat 3: CarlaBBruni (€2.80 in chips) 
Seat 4: caduceus369 (€3.35 in chips) 
Seat 5: gas888 (€3.04 in chips) 
Seat 6: Samunho01 (€2.57 in chips) 
Crock361: posts small blind €0.01
CarlaBBruni: posts big blind €0.02
*** HOLE CARDS ***
Dealt to caduceus369 [7c Qd]
caduceus369: folds 
gas888: raises €0.02 to €0.04
Samunho01: folds 
2PaperelaSgubio: folds 
Crock361: folds 
CarlaBBruni: folds 
Uncalled bet (€0.02) returned to gas888
gas888 collected €0.05 from pot
gas888: doesn't show hand 
*** SUMMARY ***
Total pot €0.05 | Rake €0 
Seat 1: 2PaperelaSgubio (button) folded before Flop (didn't bet)
Seat 2: Crock361 (small blind) folded before Flop
Seat 3: CarlaBBruni (big blind) folded before Flop
Seat 4: caduceus369 folded before Flop (didn't bet)
Seat 5: gas888 collected (€0.05)
Seat 6: Samunho01 folded before Flop (didn't bet)



PokerStars Zoom Hand #258128701344:  Hold'em No Limit (€0.01/€0.02) [ADM ID: M62C63044C87BABT] - 2025/10/15 0:27:10 CET [2025/10/14 18:27:10 ET]
Table 'Sirio' 6-max Seat #1 is the button
Seat 1: caduceus369 (€3.35 in chips) 
Seat 2: maury999999 (€5.39 in chips) 
Seat 3: fragolone100 (€0.88 in chips) 
Seat 4: Warterror90 (€2 in chips) 
Seat 5: TheMule1454 (€1.89 in chips) 
Seat 6: ADRIAN0_MEIS (€3.69 in chips) 
maury999999: posts small blind €0.01
fragolone100: posts big blind €0.02
*** HOLE CARDS ***
Dealt to caduceus369 [6h 2h]
Warterror90: folds 
TheMule1454: raises €0.06 to €0.08
ADRIAN0_MEIS: folds 
caduceus369: folds 
maury999999: folds 
fragolone100: folds 
Uncalled bet (€0.06) returned to TheMule1454
TheMule1454 collected €0.05 from pot
TheMule1454: doesn't show hand 
*** SUMMARY ***
Total pot €0.05 | Rake €0 
Seat 1: caduceus369 (button) folded before Flop (didn't bet)
Seat 2: maury999999 (small blind) folded before Flop
Seat 3: fragolone100 (big blind) folded before Flop
Seat 4: Warterror90 folded before Flop (didn't bet)
Seat 5: TheMule1454 collected (€0.05)
Seat 6: ADRIAN0_MEIS folded before Flop (didn't bet)



PokerStars Zoom Hand #258128709936:  Hold'em No Limit (€0.01/€0.02) [ADM ID: M62C63044C87BABT] - 2025/10/15 0:27:52 CET [2025/10/14 18:27:52 ET]
Table 'Sirio' 6-max Seat #1 is the button
Seat 1: Samunho01 (€2.55 in chips) 
Seat 2: meteco79 (€1.42 in chips) 
Seat 3: gas888 (€3.06 in chips) 
Seat 4: mashallahh (€7.43 in chips) 
Seat 5: caduceus369 (€3.35 in chips) 
Seat 6: TheMule1454 (€1.97 in chips) 
meteco79: posts small blind €0.01
gas888: posts big blind €0.02
*** HOLE CARDS ***
Dealt to caduceus369 [Jh Ad]
mashallahh: folds 
caduceus369: raises €0.04 to €0.06
TheMule1454: folds 
Samunho01: folds 
meteco79: folds 
gas888: folds 
Uncalled bet (€0.04) returned to caduceus369
caduceus369 collected €0.05 from pot
caduceus369: doesn't show hand 
*** SUMMARY ***
Total pot €0.05 | Rake €0 
Seat 1: Samunho01 (button) folded before Flop (didn't bet)
Seat 2: meteco79 (small blind) folded before Flop
Seat 3: gas888 (big blind) folded before Flop
Seat 4: mashallahh folded before Flop (didn't bet)
Seat 5: caduceus369 collected (€0.05)
Seat 6: TheMule1454 folded before Flop (didn't bet)



PokerStars Zoom Hand #258128705646:  Hold'em No Limit (€0.01/€0.02) [ADM ID: M62C63044C87BABT] - 2025/10/15 0:27:31 CET [2025/10/14 18:27:31 ET]
Table 'Sirio' 6-max Seat #1 is the button
Seat 1: mashallahh (€5.33 in chips) 
Seat 2: fragolone100 (€0.86 in chips) 
Seat 3: Warterror90 (€4.07 in chips) 
Seat 4: bv0360 (€0.93 in chips) 
Seat 5: molgi (€1.65 in chips) 
Seat 6: caduceus369 (€3.35 in chips) 
fragolone100: posts small blind €0.01
Warterror90: posts big blind €0.02
*** HOLE CARDS ***
Dealt to caduceus369 [Th Qs]
bv0360: folds 
molgi: raises €0.09 to €0.11
caduceus369: folds 
mashallahh: folds 
fragolone100: folds 
Warterror90: calls €0.09
*** FLOP *** [2s Jc Ac]
Warterror90: bets €0.06
molgi: raises €0.34 to €0.40
Warterror90: folds 
Uncalled bet (€0.34) returned to molgi
molgi collected €0.34 from pot
molgi: doesn't show hand 
*** SUMMARY ***
Total pot €0.35 | Rake €0.01 
Board [2s Jc Ac]
Seat 1: mashallahh (button) folded before Flop (didn't bet)
Seat 2: fragolone100 (small blind) folded before Flop
Seat 3: Warterror90 (big blind) folded on the Flop
Seat 4: bv0360 folded before Flop (didn't bet)
Seat 5: molgi collected (€0.34)
Seat 6: caduceus369 folded before Flop (didn't bet)



PokerStars Zoom Hand #258128716138:  Hold'em No Limit (€0.01/€0.02) [ADM ID: M62C63044C87BABT] - 2025/10/15 0:28:22 CET [2025/10/14 18:28:22 ET]
Table 'Sirio' 6-max Seat #1 is the button
Seat 1: TheMule1454 (€1.90 in chips) 
Seat 2: CarlaBBruni (€2.64 in chips) 
Seat 3: caduceus369 (€3.38 in chips) 
Seat 4: plutonexx (€2.17 in chips) 
Seat 5: mashallahh (€5.32 in chips) 
Seat 6: Fraxasso (€4.56 in chips) 
CarlaBBruni: posts small blind €0.01
caduceus369: posts big blind €0.02
*** HOLE CARDS ***
Dealt to caduceus369 [4h Th]
plutonexx: raises €0.02 to €0.04
mashallahh: folds 
Fraxasso: folds 
TheMule1454: folds 
CarlaBBruni: folds 
caduceus369: folds 
Uncalled bet (€0.02) returned to plutonexx
plutonexx collected €0.05 from pot
plutonexx: doesn't show hand 
*** SUMMARY ***
Total pot €0.05 | Rake €0 
Seat 1: TheMule1454 (button) folded before Flop (didn't bet)
Seat 2: CarlaBBruni (small blind) folded before Flop
Seat 3: caduceus369 (big blind) folded before Flop
Seat 4: plutonexx collected (€0.05)
Seat 5: mashallahh folded before Flop (didn't bet)
Seat 6: Fraxasso folded before Flop (didn't bet)



PokerStars Zoom Hand #258128719459:  Hold'em No Limit (€0.01/€0.02) [ADM ID: M62C63044C87BABT] - 2025/10/15 0:28:39 CET [2025/10/14 18:28:39 ET]
Table 'Sirio' 6-max Seat #1 is the button
Seat 1: plutonexx (€2.20 in chips) 
Seat 2: Samunho01 (€2.58 in chips) 
Seat 3: mashallahh (€5.32 in chips) 
Seat 4: TheMule1454 (€1.58 in chips) 
Seat 5: Fraxasso (€4.37 in chips) 
Seat 6: caduceus369 (€3.36 in chips) 
Samunho01: posts small blind €0.01
mashallahh: posts big blind €0.02
*** HOLE CARDS ***
Dealt to caduceus369 [2d 7c]
TheMule1454: folds 
Fraxasso: raises €0.02 to €0.04
caduceus369: folds 
plutonexx: raises €2.16 to €2.20 and is all-in
Samunho01: folds 
mashallahh: folds 
Fraxasso: folds 
Uncalled bet (€2.16) returned to plutonexx
plutonexx collected €0.11 from pot
plutonexx: doesn't show hand 
*** SUMMARY ***
Total pot €0.11 | Rake €0 
Seat 1: plutonexx (button) collected (€0.11)
Seat 2: Samunho01 (small blind) folded before Flop
Seat 3: mashallahh (big blind) folded before Flop
Seat 4: TheMule1454 folded before Flop (didn't bet)
Seat 5: Fraxasso folded before Flop
Seat 6: caduceus369 folded before Flop (didn't bet)



PokerStars Zoom Hand #258128720779:  Hold'em No Limit (€0.01/€0.02) [ADM ID: M62C63044C87BABT] - 2025/10/15 0:28:45 CET [2025/10/14 18:28:45 ET]
Table 'Sirio' 6-max Seat #1 is the button
Seat 1: fragolone100 (€0.77 in chips) 
Seat 2: caduceus369 (€3.36 in chips) 
Seat 3: Warterror90 (€3.81 in chips) 
Seat 4: BiscottinoXXL (€2 in chips) 
Seat 5: CIKO71131 (€0.63 in chips) 
Seat 6: Vitto oolin (€1.28 in chips) 
caduceus369: posts small blind €0.01
Warterror90: posts big blind €0.02
*** HOLE CARDS ***
Dealt to caduceus369 [Ah 3c]
BiscottinoXXL: folds 
CIKO71131: folds 
Vitto oolin: raises €0.03 to €0.05
fragolone100: folds 
caduceus369: folds 
Warterror90: folds 
Uncalled bet (€0.03) returned to Vitto oolin
Vitto oolin collected €0.05 from pot
Vitto oolin: doesn't show hand 
*** SUMMARY ***
Total pot €0.05 | Rake €0 
Seat 1: fragolone100 (button) folded before Flop (didn't bet)
Seat 2: caduceus369 (small blind) folded before Flop
Seat 3: Warterror90 (big blind) folded before Flop
Seat 4: BiscottinoXXL folded before Flop (didn't bet)
Seat 5: CIKO71131 folded before Flop (didn't bet)
Seat 6: Vitto oolin collected (€0.05)



PokerStars Zoom Hand #258128727071:  Hold'em No Limit (€0.01/€0.02) [ADM ID: M62C63044C87BABT] - 2025/10/15 0:29:15 CET [2025/10/14 18:29:15 ET]
Table 'Sirio' 6-max Seat #1 is the button
Seat 1: Catania838 (€2 in chips) 
Seat 2: TheMule1454 (€1.90 in chips) 
Seat 3: Vitto oolin (€1.31 in chips) 
Seat 4: caduceus369 (€3.35 in chips) 
Seat 5: 2PaperelaSgubio (€2.56 in chips) 
Seat 6: father2008 (€2 in chips) 
TheMule1454: posts small blind €0.01
Vitto oolin: posts big blind €0.02
*** HOLE CARDS ***
Dealt to caduceus369 [2c 8d]
caduceus369: folds 
2PaperelaSgubio: folds 
father2008: folds 
Catania838: folds 
TheMule1454: raises €0.04 to €0.06
Vitto oolin: calls €0.04
*** FLOP *** [6s 3s Qc]
TheMule1454: bets €0.12
Vitto oolin: calls €0.12
*** TURN *** [6s 3s Qc] [Qd]
TheMule1454: bets €0.35
Vitto oolin: folds 
Uncalled bet (€0.35) returned to TheMule1454
TheMule1454 collected €0.35 from pot
TheMule1454: doesn't show hand 
*** SUMMARY ***
Total pot €0.36 | Rake €0.01 
Board [6s 3s Qc Qd]
Seat 1: Catania838 (button) folded before Flop (didn't bet)
Seat 2: TheMule1454 (small blind) collected (€0.35)
Seat 3: Vitto oolin (big blind) folded on the Turn
Seat 4: caduceus369 folded before Flop (didn't bet)
Seat 5: 2PaperelaSgubio folded before Flop (didn't bet)
Seat 6: father2008 folded before Flop (didn't bet)



PokerStars Zoom Hand #258128728751:  Hold'em No Limit (€0.01/€0.02) [ADM ID: M62C63044C87BABT] - 2025/10/15 0:29:24 CET [2025/10/14 18:29:24 ET]
Table 'Sirio' 6-max Seat #1 is the button
Seat 1: Warterror90 (€3.79 in chips) 
Seat 2: CarlaBBruni (€2.77 in chips) 
Seat 3: molgi (€2.05 in chips) 
Seat 4: Samunho01 (€2.57 in chips) 
Seat 5: caduceus369 (€3.35 in chips) 
Seat 6: mashallahh (€3.85 in chips) 
CarlaBBruni: posts small blind €0.01
molgi: posts big blind €0.02
*** HOLE CARDS ***
Dealt to caduceus369 [6d 6s]
Samunho01: raises €0.04 to €0.06
caduceus369: calls €0.06
mashallahh: folds 
Warterror90: folds 
CarlaBBruni: folds 
molgi: folds 
*** FLOP *** [Kh 5s 7d]
Samunho01: bets €0.07
caduceus369: folds 
Uncalled bet (€0.07) returned to Samunho01
Samunho01 collected €0.15 from pot
Samunho01: doesn't show hand 
*** SUMMARY ***
Total pot €0.15 | Rake €0 
Board [Kh 5s 7d]
Seat 1: Warterror90 (button) folded before Flop (didn't bet)
Seat 2: CarlaBBruni (small blind) folded before Flop
Seat 3: molgi (big blind) folded before Flop
Seat 4: Samunho01 collected (€0.15)
Seat 5: caduceus369 folded on the Flop
Seat 6: mashallahh folded before Flop (didn't bet)



PokerStars Zoom Hand #258128725297:  Hold'em No Limit (€0.01/€0.02) [ADM ID: M62C63044C87BABT] - 2025/10/15 0:29:07 CET [2025/10/14 18:29:07 ET]
Table 'Sirio' 6-max Seat #1 is the button
Seat 1: caduceus369 (€3.35 in chips) 
Seat 2: Rrrr322 (€1.14 in chips) 
Seat 3: mashallahh (€7.38 in chips) 
Seat 4: This Heat (€2.50 in chips) 
Seat 5: TheMule1454 (€1.57 in chips) 
Seat 6: Freddy15081988 (€0.99 in chips) 
Rrrr322: posts small blind €0.01
mashallahh: posts big blind €0.02
*** HOLE CARDS ***
Dealt to caduceus369 [2c Ad]
This Heat: raises €0.04 to €0.06
TheMule1454: folds 
Freddy15081988: folds 
caduceus369: folds 
Rrrr322: calls €0.05
mashallahh: folds 
*** FLOP *** [Qd 9s 8s]
Rrrr322: checks 
This Heat: checks 
*** TURN *** [Qd 9s 8s] [2d]
Rrrr322: checks 
This Heat: bets €0.08
Rrrr322: calls €0.08
*** RIVER *** [Qd 9s 8s 2d] [4h]
Rrrr322: checks 
This Heat: bets €0.15
Rrrr322: calls €0.15
*** SHOW DOWN ***
This Heat: shows [As 4s] (a pair of Fours)
Rrrr322: shows [9d 6c] (a pair of Nines)
Rrrr322 collected €0.57 from pot
*** SUMMARY ***
Total pot €0.60 | Rake €0.03 
Board [Qd 9s 8s 2d 4h]
Seat 1: caduceus369 (button) folded before Flop (didn't bet)
Seat 2: Rrrr322 (small blind) showed [9d 6c] and won (€0.57) with a pair of Nines
Seat 3: mashallahh (big blind) folded before Flop
Seat 4: This Heat showed [As 4s] and lost with a pair of Fours
Seat 5: TheMule1454 folded before Flop (didn't bet)
Seat 6: Freddy15081988 folded before Flop (didn't bet)



PokerStars Zoom Hand #258128743152:  Hold'em No Limit (€0.01/€0.02) [ADM ID: M62C63044C87BABT] - 2025/10/15 0:30:35 CET [2025/10/14 18:30:35 ET]
Table 'Sirio' 6-max Seat #1 is the button
Seat 1: McSup (€2.41 in chips) 
Seat 2: mashallahh (€7.36 in chips) 
Seat 3: meteco79 (€1.37 in chips) 
Seat 4: TheMule1454 (€2.05 in chips) 
Seat 5: Fraxasso (€3.24 in chips) 
Seat 6: caduceus369 (€3.27 in chips) 
mashallahh: posts small blind €0.01
meteco79: posts big blind €0.02
*** HOLE CARDS ***
Dealt to caduceus369 [7c 6h]
TheMule1454: folds 
Fraxasso: folds 
caduceus369: folds 
McSup: folds 
mashallahh: folds 
Uncalled bet (€0.01) returned to meteco79
meteco79 collected €0.02 from pot
meteco79: doesn't show hand 
*** SUMMARY ***
Total pot €0.02 | Rake €0 
Seat 1: McSup (button) folded before Flop (didn't bet)
Seat 2: mashallahh (small blind) folded before Flop
Seat 3: meteco79 (big blind) collected (€0.02)
Seat 4: TheMule1454 folded before Flop (didn't bet)
Seat 5: Fraxasso folded before Flop (didn't bet)
Seat 6: caduceus369 folded before Flop (didn't bet)



PokerStars Zoom Hand #258128744351:  Hold'em No Limit (€0.01/€0.02) [ADM ID: M62C63044C87BABT] - 2025/10/15 0:30:41 CET [2025/10/14 18:30:41 ET]
Table 'Sirio' 6-max Seat #1 is the button
Seat 1: Warterror90 (€2.58 in chips) 
Seat 2: CIKO71131 (€0.86 in chips) 
Seat 3: Fraxasso (€3.24 in chips) 
Seat 4: caduceus369 (€3.27 in chips) 
Seat 5: father2008 (€2 in chips) 
Seat 6: Crock361 (€2.06 in chips) 
CIKO71131: posts small blind €0.01
Fraxasso: posts big blind €0.02
*** HOLE CARDS ***
Dealt to caduceus369 [Kc 8d]
caduceus369: folds 
father2008: raises €0.04 to €0.06
Crock361: folds 
Warterror90: folds 
CIKO71131: calls €0.05
Fraxasso: folds 
*** FLOP *** [4d 7d Qh]
CIKO71131: checks 
father2008: checks 
*** TURN *** [4d 7d Qh] [Kh]
CIKO71131: checks 
father2008: bets €0.08
CIKO71131: calls €0.08
*** RIVER *** [4d 7d Qh Kh] [2d]
CIKO71131: checks 
father2008: checks 
*** SHOW DOWN ***
CIKO71131: shows [6h 4h] (a pair of Fours)
father2008: shows [Ac Kd] (a pair of Kings)
father2008 collected €0.29 from pot
*** SUMMARY ***
Total pot €0.30 | Rake €0.01 
Board [4d 7d Qh Kh 2d]
Seat 1: Warterror90 (button) folded before Flop (didn't bet)
Seat 2: CIKO71131 (small blind) showed [6h 4h] and lost with a pair of Fours
Seat 3: Fraxasso (big blind) folded before Flop
Seat 4: caduceus369 folded before Flop (didn't bet)
Seat 5: father2008 showed [Ac Kd] and won (€0.29) with a pair of Kings
Seat 6: Crock361 folded before Flop (didn't bet)



PokerStars Zoom Hand #258128747391:  Hold'em No Limit (€0.01/€0.02) [ADM ID: M62C63044C87BABT] - 2025/10/15 0:30:56 CET [2025/10/14 18:30:56 ET]
Table 'Sirio' 6-max Seat #1 is the button
Seat 1: TheMule1454 (€3.08 in chips) 
Seat 2: caduceus369 (€3.27 in chips) 
Seat 3: mashallahh (€7.35 in chips) 
Seat 4: Freddy15081988 (€0.96 in chips) 
Seat 5: cryyh (€3.35 in chips) 
Seat 6: Crock361 (€2.06 in chips) 
caduceus369: posts small blind €0.01
mashallahh: posts big blind €0.02
*** HOLE CARDS ***
Dealt to caduceus369 [2h Jd]
Freddy15081988: calls €0.02
cryyh: folds 
Crock361: folds 
TheMule1454: raises €0.08 to €0.10
caduceus369: folds 
mashallahh: folds 
Freddy15081988: folds 
Uncalled bet (€0.08) returned to TheMule1454
TheMule1454 collected €0.07 from pot
TheMule1454: doesn't show hand 
*** SUMMARY ***
Total pot €0.07 | Rake €0 
Seat 1: TheMule1454 (button) collected (€0.07)
Seat 2: caduceus369 (small blind) folded before Flop
Seat 3: mashallahh (big blind) folded before Flop
Seat 4: Freddy15081988 folded before Flop
Seat 5: cryyh folded before Flop (didn't bet)
Seat 6: Crock361 folded before Flop (didn't bet)



PokerStars Zoom Hand #258128738884:  Hold'em No Limit (€0.01/€0.02) [ADM ID: M62C63044C87BABT] - 2025/10/15 0:30:14 CET [2025/10/14 18:30:14 ET]
Table 'Sirio' 6-max Seat #1 is the button
Seat 1: mashallahh (€3.86 in chips) 
Seat 2: BiscottinoXXL (€2 in chips) 
Seat 3: caduceus369 (€3.29 in chips) 
Seat 4: CarlaBBruni (€2.61 in chips) 
Seat 5: Crock361 (€2.06 in chips) 
Seat 6: meteco79 (€1.39 in chips) 
BiscottinoXXL: posts small blind €0.01
caduceus369: posts big blind €0.02
*** HOLE CARDS ***
Dealt to caduceus369 [8d 9c]
CarlaBBruni: folds 
Crock361: folds 
meteco79: calls €0.02
mashallahh: raises €0.06 to €0.08
BiscottinoXXL: raises €0.16 to €0.24
caduceus369: folds 
meteco79: folds 
mashallahh: raises €0.48 to €0.72
BiscottinoXXL: calls €0.48
*** FLOP *** [2d 2s 9s]
BiscottinoXXL: bets €0.70
mashallahh: raises €0.70 to €1.40
BiscottinoXXL: calls €0.58 and is all-in
Uncalled bet (€0.12) returned to mashallahh
*** TURN *** [2d 2s 9s] [Qd]
*** RIVER *** [2d 2s 9s Qd] [2c]
*** SHOW DOWN ***
BiscottinoXXL: shows [Jc Js] (a full house, Deuces full of Jacks)
mashallahh: shows [Td Ts] (a full house, Deuces full of Tens)
BiscottinoXXL collected €3.82 from pot
*** SUMMARY ***
Total pot €4.04 | Rake €0.22 
Board [2d 2s 9s Qd 2c]
Seat 1: mashallahh (button) showed [Td Ts] and lost with a full house, Deuces full of Tens
Seat 2: BiscottinoXXL (small blind) showed [Jc Js] and won (€3.82) with a full house, Deuces full of Jacks
Seat 3: caduceus369 (big blind) folded before Flop
Seat 4: CarlaBBruni folded before Flop (didn't bet)
Seat 5: Crock361 folded before Flop (didn't bet)
Seat 6: meteco79 folded before Flop



PokerStars Zoom Hand #258128748433:  Hold'em No Limit (€0.01/€0.02) [ADM ID: M62C63044C87BABT] - 2025/10/15 0:31:01 CET [2025/10/14 18:31:01 ET]
Table 'Sirio' 6-max Seat #1 is the button
Seat 1: caduceus369 (€3.26 in chips) 
Seat 2: meteco79 (€1.38 in chips) 
Seat 3: Rrrr322 (€1.36 in chips) 
Seat 4: ADRIAN0_MEIS (€3.94 in chips) 
Seat 5: maury999999 (€7.30 in chips) 
Seat 6: Warterror90 (€2.58 in chips) 
meteco79: posts small blind €0.01
Rrrr322: posts big blind €0.02
*** HOLE CARDS ***
Dealt to caduceus369 [6d 5c]
ADRIAN0_MEIS: folds 
maury999999: folds 
Warterror90: folds 
caduceus369: raises €0.04 to €0.06
meteco79: folds 
Rrrr322: calls €0.04
*** FLOP *** [Qd Ts 4h]
Rrrr322: checks 
caduceus369: checks 
*** TURN *** [Qd Ts 4h] [7h]
Rrrr322: checks 
caduceus369: bets €0.04
Rrrr322: calls €0.04
*** RIVER *** [Qd Ts 4h 7h] [3s]
Rrrr322: bets €0.08
caduceus369: raises €0.18 to €0.26
Rrrr322: calls €0.18
*** SHOW DOWN ***
caduceus369: shows [6d 5c] (a straight, Three to Seven)
Rrrr322: mucks hand 
caduceus369 collected €0.69 from pot
*** SUMMARY ***
Total pot €0.73 | Rake €0.04 
Board [Qd Ts 4h 7h 3s]
Seat 1: caduceus369 (button) showed [6d 5c] and won (€0.69) with a straight, Three to Seven
Seat 2: meteco79 (small blind) folded before Flop
Seat 3: Rrrr322 (big blind) mucked [7c 8s]
Seat 4: ADRIAN0_MEIS folded before Flop (didn't bet)
Seat 5: maury999999 folded before Flop (didn't bet)
Seat 6: Warterror90 folded before Flop (didn't bet)



PokerStars Zoom Hand #258128762984:  Hold'em No Limit (€0.01/€0.02) [ADM ID: M62C63044C87BABT] - 2025/10/15 0:32:13 CET [2025/10/14 18:32:13 ET]
Table 'Sirio' 6-max Seat #1 is the button
Seat 1: mashallahh (€7.50 in chips) 
Seat 2: Warterror90 (€3.17 in chips) 
Seat 3: Fraxasso (€3.17 in chips) 
Seat 4: caduceus369 (€3.59 in chips) 
Seat 5: CarlaBBruni (€2.49 in chips) 
Seat 6: meteco79 (€1.27 in chips) 
Warterror90: posts small blind €0.01
Fraxasso: posts big blind €0.02
*** HOLE CARDS ***
Dealt to caduceus369 [Ad 3s]
caduceus369: folds 
CarlaBBruni: raises €0.02 to €0.04
meteco79: folds 
mashallahh: raises €0.14 to €0.18
Warterror90: folds 
Fraxasso: folds 
CarlaBBruni: folds 
Uncalled bet (€0.14) returned to mashallahh
mashallahh collected €0.11 from pot
mashallahh: doesn't show hand 
*** SUMMARY ***
Total pot €0.11 | Rake €0 
Seat 1: mashallahh (button) collected (€0.11)
Seat 2: Warterror90 (small blind) folded before Flop
Seat 3: Fraxasso (big blind) folded before Flop
Seat 4: caduceus369 folded before Flop (didn't bet)
Seat 5: CarlaBBruni folded before Flop
Seat 6: meteco79 folded before Flop (didn't bet)



PokerStars Zoom Hand #258128764038:  Hold'em No Limit (€0.01/€0.02) [ADM ID: M62C63044C87BABT] - 2025/10/15 0:32:19 CET [2025/10/14 18:32:19 ET]
Table 'Sirio' 6-max Seat #1 is the button
Seat 1: Warterror90 (€3.16 in chips) 
Seat 2: meteco79 (€1.27 in chips) 
Seat 3: caduceus369 (€3.59 in chips) 
Seat 4: aurelios2 (€10.77 in chips) 
Seat 5: 66lanci66 (€2 in chips) 
Seat 6: Catania838 (€1.92 in chips) 
meteco79: posts small blind €0.01
caduceus369: posts big blind €0.02
*** HOLE CARDS ***
Dealt to caduceus369 [Ah 8c]
aurelios2: folds 
66lanci66: folds 
Catania838: calls €0.02
Warterror90: folds 
meteco79: folds 
caduceus369: checks 
*** FLOP *** [Qs 2d Qc]
caduceus369: checks 
Catania838: checks 
*** TURN *** [Qs 2d Qc] [7d]
caduceus369: bets €0.04
Catania838: folds 
Uncalled bet (€0.04) returned to caduceus369
caduceus369 collected €0.05 from pot
caduceus369: doesn't show hand 
*** SUMMARY ***
Total pot €0.05 | Rake €0 
Board [Qs 2d Qc 7d]
Seat 1: Warterror90 (button) folded before Flop (didn't bet)
Seat 2: meteco79 (small blind) folded before Flop
Seat 3: caduceus369 (big blind) collected (€0.05)
Seat 4: aurelios2 folded before Flop (didn't bet)
Seat 5: 66lanci66 folded before Flop (didn't bet)
Seat 6: Catania838 folded on the Turn



PokerStars Zoom Hand #258128769159:  Hold'em No Limit (€0.01/€0.02) [ADM ID: M62C63044C87BABT] - 2025/10/15 0:32:44 CET [2025/10/14 18:32:44 ET]
Table 'Sirio' 6-max Seat #1 is the button
Seat 1: Crock361 (€1.98 in chips) 
Seat 2: CarlaBBruni (€2.43 in chips) 
Seat 3: ADRIAN0_MEIS (€3.94 in chips) 
Seat 4: Catania838 (€1.90 in chips) 
Seat 5: Warterror90 (€4.03 in chips) 
Seat 6: caduceus369 (€3.62 in chips) 
CarlaBBruni: posts small blind €0.01
ADRIAN0_MEIS: posts big blind €0.02
*** HOLE CARDS ***
Dealt to caduceus369 [5h Tc]
Catania838: calls €0.02
Warterror90: folds 
caduceus369: folds 
Crock361: folds 
CarlaBBruni: folds 
ADRIAN0_MEIS: checks 
*** FLOP *** [Kc 2c 4s]
ADRIAN0_MEIS: bets €0.04
Catania838: folds 
Uncalled bet (€0.04) returned to ADRIAN0_MEIS
ADRIAN0_MEIS collected €0.05 from pot
ADRIAN0_MEIS: doesn't show hand 
*** SUMMARY ***
Total pot €0.05 | Rake €0 
Board [Kc 2c 4s]
Seat 1: Crock361 (button) folded before Flop (didn't bet)
Seat 2: CarlaBBruni (small blind) folded before Flop
Seat 3: ADRIAN0_MEIS (big blind) collected (€0.05)
Seat 4: Catania838 folded on the Flop
Seat 5: Warterror90 folded before Flop (didn't bet)
Seat 6: caduceus369 folded before Flop (didn't bet)



PokerStars Zoom Hand #258128761149:  Hold'em No Limit (€0.01/€0.02) [ADM ID: M62C63044C87BABT] - 2025/10/15 0:32:04 CET [2025/10/14 18:32:04 ET]
Table 'Sirio' 6-max Seat #1 is the button
Seat 1: McSup (€2.47 in chips) 
Seat 2: BiscottinoXXL (€2 in chips) 
Seat 3: bv0360 (€0.62 in chips) 
Seat 4: caduceus369 (€3.59 in chips) 
Seat 5: maury999999 (€4.42 in chips) 
Seat 6: Begimon (€12.54 in chips) 
BiscottinoXXL: posts small blind €0.01
bv0360: posts big blind €0.02
*** HOLE CARDS ***
Dealt to caduceus369 [Jh 5h]
caduceus369: folds 
maury999999: folds 
Begimon: calls €0.02
McSup: raises €0.02 to €0.04
BiscottinoXXL: raises €0.04 to €0.08
bv0360: calls €0.06
Begimon: calls €0.06
McSup: calls €0.04
*** FLOP *** [4c Jc 9s]
BiscottinoXXL: bets €0.16
bv0360: folds 
Begimon: folds 
McSup: calls €0.16
*** TURN *** [4c Jc 9s] [7d]
BiscottinoXXL: bets €0.31
McSup: calls €0.31
*** RIVER *** [4c Jc 9s 7d] [7s]
BiscottinoXXL: bets €1.45 and is all-in
McSup: calls €1.45
*** SHOW DOWN ***
BiscottinoXXL: shows [Qd Qs] (two pair, Queens and Sevens)
McSup: shows [Js Kc] (two pair, Jacks and Sevens)
BiscottinoXXL collected €3.94 from pot
*** SUMMARY ***
Total pot €4.16 | Rake €0.22 
Board [4c Jc 9s 7d 7s]
Seat 1: McSup (button) showed [Js Kc] and lost with two pair, Jacks and Sevens
Seat 2: BiscottinoXXL (small blind) showed [Qd Qs] and won (€3.94) with two pair, Queens and Sevens
Seat 3: bv0360 (big blind) folded on the Flop
Seat 4: caduceus369 folded before Flop (didn't bet)
Seat 5: maury999999 folded before Flop (didn't bet)
Seat 6: Begimon folded on the Flop



PokerStars Zoom Hand #258128774640:  Hold'em No Limit (€0.01/€0.02) [ADM ID: M62C63044C87BABT] - 2025/10/15 0:33:12 CET [2025/10/14 18:33:12 ET]
Table 'Sirio' 6-max Seat #1 is the button
Seat 1: caduceus369 (€3.62 in chips) 
Seat 2: TheMule1454 (€1.84 in chips) 
Seat 3: Fraxasso (€4.52 in chips) 
Seat 4: Rrrr322 (€0.88 in chips) 
Seat 5: Warterror90 (€3.38 in chips) 
Seat 6: BiscottinoXXL (€3.94 in chips) 
TheMule1454: posts small blind €0.01
Fraxasso: posts big blind €0.02
*** HOLE CARDS ***
Dealt to caduceus369 [Kd 6d]
Rrrr322: calls €0.02
Warterror90: folds 
BiscottinoXXL: folds 
caduceus369: folds 
TheMule1454: folds 
Fraxasso: checks 
*** FLOP *** [4s Qh Qc]
Fraxasso: checks 
Rrrr322: checks 
*** TURN *** [4s Qh Qc] [2s]
Fraxasso: checks 
Rrrr322: checks 
*** RIVER *** [4s Qh Qc 2s] [8d]
Fraxasso: checks 
Rrrr322: bets €0.06
Fraxasso: folds 
Uncalled bet (€0.06) returned to Rrrr322
Rrrr322 collected €0.05 from pot
Rrrr322: doesn't show hand 
*** SUMMARY ***
Total pot €0.05 | Rake €0 
Board [4s Qh Qc 2s 8d]
Seat 1: caduceus369 (button) folded before Flop (didn't bet)
Seat 2: TheMule1454 (small blind) folded before Flop
Seat 3: Fraxasso (big blind) folded on the River
Seat 4: Rrrr322 collected (€0.05)
Seat 5: Warterror90 folded before Flop (didn't bet)
Seat 6: BiscottinoXXL folded before Flop (didn't bet)



PokerStars Zoom Hand #258128778057:  Hold'em No Limit (€0.01/€0.02) [ADM ID: M62C63044C87BABT] - 2025/10/15 0:33:29 CET [2025/10/14 18:33:29 ET]
Table 'Sirio' 6-max Seat #1 is the button
Seat 1: ADRIAN0_MEIS (€3.97 in chips) 
Seat 2: caduceus369 (€3.62 in chips) 
Seat 3: mashallahh (€5.32 in chips) 
Seat 4: TheMule1454 (€1.54 in chips) 
Seat 5: Vitto oolin (€0.95 in chips) 
Seat 6: franck19621962 (€1.52 in chips) 
caduceus369: posts small blind €0.01
mashallahh: posts big blind €0.02
*** HOLE CARDS ***
Dealt to caduceus369 [Kc Ks]
TheMule1454: folds 
Vitto oolin: folds 
franck19621962: calls €0.02
ADRIAN0_MEIS: raises €0.02 to €0.04
caduceus369: raises €0.10 to €0.14
mashallahh: folds 
franck19621962: folds 
ADRIAN0_MEIS: calls €0.10
*** FLOP *** [9d 9s 4h]
caduceus369: bets €0.10
ADRIAN0_MEIS: raises €0.17 to €0.27
caduceus369: calls €0.17
*** TURN *** [9d 9s 4h] [6c]
caduceus369: checks 
ADRIAN0_MEIS: bets €0.62
caduceus369: calls €0.62
*** RIVER *** [9d 9s 4h 6c] [7h]
caduceus369: bets €1.49
ADRIAN0_MEIS: calls €1.49
*** SHOW DOWN ***
caduceus369: shows [Kc Ks] (two pair, Kings and Nines)
ADRIAN0_MEIS: mucks hand 
caduceus369 collected €4.81 from pot
*** SUMMARY ***
Total pot €5.08 | Rake €0.27 
Board [9d 9s 4h 6c 7h]
Seat 1: ADRIAN0_MEIS (button) mucked [7c Ah]
Seat 2: caduceus369 (small blind) showed [Kc Ks] and won (€4.81) with two pair, Kings and Nines
Seat 3: mashallahh (big blind) folded before Flop
Seat 4: TheMule1454 folded before Flop (didn't bet)
Seat 5: Vitto oolin folded before Flop (didn't bet)
Seat 6: franck19621962 folded before Flop



PokerStars Zoom Hand #258128799309:  Hold'em No Limit (€0.01/€0.02) [ADM ID: M62C63044C87BABT] - 2025/10/15 0:35:15 CET [2025/10/14 18:35:15 ET]
Table 'Sirio' 6-max Seat #1 is the button
Seat 1: mashallahh (€7.36 in chips) 
Seat 2: Alifatti (€0.78 in chips) 
Seat 3: Begimon (€12.99 in chips) 
Seat 4: father2008 (€2.18 in chips) 
Seat 5: caduceus369 (€5.91 in chips) 
Seat 6: TheMule1454 (€3.09 in chips) 
Alifatti: posts small blind €0.01
Begimon: posts big blind €0.02
*** HOLE CARDS ***
Dealt to caduceus369 [Kc 4c]
father2008: folds 
caduceus369: folds 
TheMule1454: folds 
mashallahh: folds 
Alifatti: calls €0.01
Begimon: checks 
*** FLOP *** [5s 4h 7h]
Alifatti: checks 
Begimon: checks 
*** TURN *** [5s 4h 7h] [As]
Alifatti: checks 
Begimon: bets €0.02
Alifatti: calls €0.02
*** RIVER *** [5s 4h 7h As] [Ks]
Alifatti: checks 
Begimon: bets €0.02
Alifatti: calls €0.02
*** SHOW DOWN ***
Begimon: shows [Ac Jc] (a pair of Aces)
Alifatti: mucks hand 
Begimon collected €0.12 from pot
*** SUMMARY ***
Total pot €0.12 | Rake €0 
Board [5s 4h 7h As Ks]
Seat 1: mashallahh (button) folded before Flop (didn't bet)
Seat 2: Alifatti (small blind) mucked [7d 6s]
Seat 3: Begimon (big blind) showed [Ac Jc] and won (€0.12) with a pair of Aces
Seat 4: father2008 folded before Flop (didn't bet)
Seat 5: caduceus369 folded before Flop (didn't bet)
Seat 6: TheMule1454 folded before Flop (didn't bet)



PokerStars Zoom Hand #258128804616:  Hold'em No Limit (€0.01/€0.02) [ADM ID: M62C63044C87BABT] - 2025/10/15 0:35:42 CET [2025/10/14 18:35:42 ET]
Table 'Sirio' 6-max Seat #1 is the button
Seat 1: father2008 (€2.31 in chips) 
Seat 2: mashallahh (€7.34 in chips) 
Seat 3: 2PaperelaSgubio (€3.07 in chips) 
Seat 4: CarlaBBruni (€2.06 in chips) 
Seat 5: caduceus369 (€5.91 in chips) 
Seat 6: Crock361 (€1.95 in chips) 
mashallahh: posts small blind €0.01
2PaperelaSgubio: posts big blind €0.02
*** HOLE CARDS ***
Dealt to caduceus369 [Jh 4s]
CarlaBBruni: folds 
caduceus369: folds 
Crock361: folds 
father2008: folds 
mashallahh: raises €0.04 to €0.06
2PaperelaSgubio: folds 
Uncalled bet (€0.04) returned to mashallahh
mashallahh collected €0.04 from pot
mashallahh: doesn't show hand 
*** SUMMARY ***
Total pot €0.04 | Rake €0 
Seat 1: father2008 (button) folded before Flop (didn't bet)
Seat 2: mashallahh (small blind) collected (€0.04)
Seat 3: 2PaperelaSgubio (big blind) folded before Flop
Seat 4: CarlaBBruni folded before Flop (didn't bet)
Seat 5: caduceus369 folded before Flop (didn't bet)
Seat 6: Crock361 folded before Flop (didn't bet)



PokerStars Zoom Hand #258128805688:  Hold'em No Limit (€0.01/€0.02) [ADM ID: M62C63044C87BABT] - 2025/10/15 0:35:47 CET [2025/10/14 18:35:47 ET]
Table 'Sirio' 6-max Seat #1 is the button
Seat 1: Warterror90 (€4.37 in chips) 
Seat 2: TheMule1454 (€3.07 in chips) 
Seat 3: caduceus369 (€5.91 in chips) 
Seat 4: Catania838 (€2.04 in chips) 
Seat 5: mashallahh (€5.40 in chips) 
Seat 6: aurelios2 (€10.01 in chips) 
TheMule1454: posts small blind €0.01
caduceus369: posts big blind €0.02
*** HOLE CARDS ***
Dealt to caduceus369 [4h 3d]
Catania838: folds 
mashallahh: folds 
aurelios2: folds 
Warterror90: raises €0.04 to €0.06
TheMule1454: folds 
caduceus369: calls €0.04
*** FLOP *** [2c As 4s]
caduceus369: checks 
Warterror90: checks 
*** TURN *** [2c As 4s] [7s]
caduceus369: bets €0.04
Warterror90: calls €0.04
*** RIVER *** [2c As 4s 7s] [9s]
caduceus369: checks 
Warterror90: bets €0.22
caduceus369: folds 
Uncalled bet (€0.22) returned to Warterror90
Warterror90 collected €0.20 from pot
Warterror90: doesn't show hand 
*** SUMMARY ***
Total pot €0.21 | Rake €0.01 
Board [2c As 4s 7s 9s]
Seat 1: Warterror90 (button) collected (€0.20)
Seat 2: TheMule1454 (small blind) folded before Flop
Seat 3: caduceus369 (big blind) folded on the River
Seat 4: Catania838 folded before Flop (didn't bet)
Seat 5: mashallahh folded before Flop (didn't bet)
Seat 6: aurelios2 folded before Flop (didn't bet)



PokerStars Zoom Hand #258128815472:  Hold'em No Limit (€0.01/€0.02) [ADM ID: M62C63044C87BABT] - 2025/10/15 0:36:36 CET [2025/10/14 18:36:36 ET]
Table 'Sirio' 6-max Seat #1 is the button
Seat 1: mashallahh (€5.22 in chips) 
Seat 2: CarlaBBruni (€3.43 in chips) 
Seat 3: TheMule1454 (€1.69 in chips) 
Seat 4: caduceus369 (€5.81 in chips) 
Seat 5: Crock361 (€2.17 in chips) 
Seat 6: Warterror90 (€4.47 in chips) 
CarlaBBruni: posts small blind €0.01
TheMule1454: posts big blind €0.02
*** HOLE CARDS ***
Dealt to caduceus369 [2c 8d]
caduceus369: folds 
Crock361: folds 
Warterror90: folds 
mashallahh: folds 
CarlaBBruni: raises €0.04 to €0.06
TheMule1454: folds 
Uncalled bet (€0.04) returned to CarlaBBruni
CarlaBBruni collected €0.04 from pot
CarlaBBruni: doesn't show hand 
*** SUMMARY ***
Total pot €0.04 | Rake €0 
Seat 1: mashallahh (button) folded before Flop (didn't bet)
Seat 2: CarlaBBruni (small blind) collected (€0.04)
Seat 3: TheMule1454 (big blind) folded before Flop
Seat 4: caduceus369 folded before Flop (didn't bet)
Seat 5: Crock361 folded before Flop (didn't bet)
Seat 6: Warterror90 folded before Flop (didn't bet)



PokerStars Zoom Hand #258128816534:  Hold'em No Limit (€0.01/€0.02) [ADM ID: M62C63044C87BABT] - 2025/10/15 0:36:41 CET [2025/10/14 18:36:41 ET]
Table 'Sirio' 6-max Seat #1 is the button
Seat 1: franck19621962 (€1.39 in chips) 
Seat 2: caduceus369 (€5.81 in chips) 
Seat 3: maury999999 (€4.39 in chips) 
Seat 4: mashallahh (€5.22 in chips) 
Seat 5: SebaRapy14 (€0.91 in chips) 
Seat 6: toscano31 (€2.96 in chips) 
caduceus369: posts small blind €0.01
maury999999: posts big blind €0.02
*** HOLE CARDS ***
Dealt to caduceus369 [7h Qh]
mashallahh: folds 
SebaRapy14: folds 
toscano31: raises €0.02 to €0.04
franck19621962: calls €0.04
caduceus369: folds 
maury999999: folds 
*** FLOP *** [4d 9s Kd]
toscano31: bets €0.11
franck19621962: folds 
Uncalled bet (€0.11) returned to toscano31
toscano31 collected €0.11 from pot
toscano31: doesn't show hand 
*** SUMMARY ***
Total pot €0.11 | Rake €0 
Board [4d 9s Kd]
Seat 1: franck19621962 (button) folded on the Flop
Seat 2: caduceus369 (small blind) folded before Flop
Seat 3: maury999999 (big blind) folded before Flop
Seat 4: mashallahh folded before Flop (didn't bet)
Seat 5: SebaRapy14 folded before Flop (didn't bet)
Seat 6: toscano31 collected (€0.11)



PokerStars Zoom Hand #258128819604:  Hold'em No Limit (€0.01/€0.02) [ADM ID: M62C63044C87BABT] - 2025/10/15 0:36:57 CET [2025/10/14 18:36:57 ET]
Table 'Sirio' 6-max Seat #1 is the button
Seat 1: caduceus369 (€5.80 in chips) 
Seat 2: Vitto oolin (€0.75 in chips) 
Seat 3: TheMule1454 (€1.88 in chips) 
Seat 4: Rrrr322 (€0.95 in chips) 
Seat 5: Agnese84 (€2.54 in chips) 
Seat 6: Crock361 (€1.93 in chips) 
Vitto oolin: posts small blind €0.01
TheMule1454: posts big blind €0.02
*** HOLE CARDS ***
Dealt to caduceus369 [2h 5c]
Rrrr322: calls €0.02
Agnese84: folds 
Crock361: folds 
caduceus369: folds 
Vitto oolin: calls €0.01
TheMule1454: checks 
*** FLOP *** [2c 6h Ah]
Vitto oolin: checks 
TheMule1454: checks 
Rrrr322: checks 
*** TURN *** [2c 6h Ah] [Ac]
Vitto oolin: checks 
TheMule1454: checks 
Rrrr322: checks 
*** RIVER *** [2c 6h Ah Ac] [4h]
Vitto oolin: checks 
TheMule1454: checks 
Rrrr322: bets €0.08
Vitto oolin: folds 
TheMule1454: folds 
Uncalled bet (€0.08) returned to Rrrr322
Rrrr322 collected €0.06 from pot
Rrrr322: doesn't show hand 
*** SUMMARY ***
Total pot €0.06 | Rake €0 
Board [2c 6h Ah Ac 4h]
Seat 1: caduceus369 (button) folded before Flop (didn't bet)
Seat 2: Vitto oolin (small blind) folded on the River
Seat 3: TheMule1454 (big blind) folded on the River
Seat 4: Rrrr322 collected (€0.06)
Seat 5: Agnese84 folded before Flop (didn't bet)
Seat 6: Crock361 folded before Flop (didn't bet)



PokerStars Zoom Hand #258128820672:  Hold'em No Limit (€0.01/€0.02) [ADM ID: M62C63044C87BABT] - 2025/10/15 0:37:02 CET [2025/10/14 18:37:02 ET]
Table 'Sirio' 6-max Seat #1 is the button
Seat 1: CarlaBBruni (€1.90 in chips) 
Seat 2: BiscottinoXXL (€4.21 in chips) 
Seat 3: 2PaperelaSgubio (€3.02 in chips) 
Seat 4: Catania838 (€2.76 in chips) 
Seat 5: maury999999 (€7.31 in chips) 
Seat 6: caduceus369 (€5.80 in chips) 
BiscottinoXXL: posts small blind €0.01
2PaperelaSgubio: posts big blind €0.02
*** HOLE CARDS ***
Dealt to caduceus369 [Th Ac]
Catania838: folds 
maury999999: folds 
caduceus369: raises €0.04 to €0.06
CarlaBBruni: folds 
BiscottinoXXL: folds 
2PaperelaSgubio: raises €0.18 to €0.24
caduceus369: folds 
Uncalled bet (€0.18) returned to 2PaperelaSgubio
2PaperelaSgubio collected €0.13 from pot
2PaperelaSgubio: doesn't show hand 
*** SUMMARY ***
Total pot €0.13 | Rake €0 
Seat 1: CarlaBBruni (button) folded before Flop (didn't bet)
Seat 2: BiscottinoXXL (small blind) folded before Flop
Seat 3: 2PaperelaSgubio (big blind) collected (€0.13)
Seat 4: Catania838 folded before Flop (didn't bet)
Seat 5: maury999999 folded before Flop (didn't bet)
Seat 6: caduceus369 folded before Flop



PokerStars Zoom Hand #258128829294:  Hold'em No Limit (€0.01/€0.02) [ADM ID: M62C63044C87BABT] - 2025/10/15 0:37:45 CET [2025/10/14 18:37:45 ET]
Table 'Sirio' 6-max Seat #1 is the button
Seat 1: ADRIAN0_MEIS (€3.77 in chips) 
Seat 2: 2PaperelaSgubio (€3.09 in chips) 
Seat 3: BiscottinoXXL (€3.75 in chips) 
Seat 4: Begimon (€12.99 in chips) 
Seat 5: father2008 (€2.18 in chips) 
Seat 6: caduceus369 (€5.74 in chips) 
2PaperelaSgubio: posts small blind €0.01
BiscottinoXXL: posts big blind €0.02
*** HOLE CARDS ***
Dealt to caduceus369 [3c Kd]
Begimon: folds 
father2008: folds 
caduceus369: folds 
ADRIAN0_MEIS: folds 
2PaperelaSgubio: raises €0.04 to €0.06
BiscottinoXXL: raises €0.12 to €0.18
2PaperelaSgubio: folds 
Uncalled bet (€0.12) returned to BiscottinoXXL
BiscottinoXXL collected €0.12 from pot
BiscottinoXXL: doesn't show hand 
*** SUMMARY ***
Total pot €0.12 | Rake €0 
Seat 1: ADRIAN0_MEIS (button) folded before Flop (didn't bet)
Seat 2: 2PaperelaSgubio (small blind) folded before Flop
Seat 3: BiscottinoXXL (big blind) collected (€0.12)
Seat 4: Begimon folded before Flop (didn't bet)
Seat 5: father2008 folded before Flop (didn't bet)
Seat 6: caduceus369 folded before Flop (didn't bet)



PokerStars Zoom Hand #258128830507:  Hold'em No Limit (€0.01/€0.02) [ADM ID: M62C63044C87BABT] - 2025/10/15 0:37:51 CET [2025/10/14 18:37:51 ET]
Table 'Sirio' 6-max Seat #1 is the button
Seat 1: Catania838 (€2.13 in chips) 
Seat 2: father2008 (€2.18 in chips) 
Seat 3: caduceus369 (€5.74 in chips) 
Seat 4: Begimon (€12.99 in chips) 
Seat 5: TheMule1454 (€1.86 in chips) 
Seat 6: Alifatti (€0.71 in chips) 
father2008: posts small blind €0.01
caduceus369: posts big blind €0.02
*** HOLE CARDS ***
Dealt to caduceus369 [Ks 4d]
Begimon: folds 
TheMule1454: folds 
Alifatti: calls €0.02
Catania838: calls €0.02
father2008: calls €0.01
caduceus369: checks 
*** FLOP *** [5d 7s 5h]
father2008: bets €0.04
caduceus369: folds 
Alifatti: folds 
Catania838: folds 
Uncalled bet (€0.04) returned to father2008
father2008 collected €0.08 from pot
father2008: doesn't show hand 
*** SUMMARY ***
Total pot €0.08 | Rake €0 
Board [5d 7s 5h]
Seat 1: Catania838 (button) folded on the Flop
Seat 2: father2008 (small blind) collected (€0.08)
Seat 3: caduceus369 (big blind) folded on the Flop
Seat 4: Begimon folded before Flop (didn't bet)
Seat 5: TheMule1454 folded before Flop (didn't bet)
Seat 6: Alifatti folded on the Flop



PokerStars Zoom Hand #258128828478:  Hold'em No Limit (€0.01/€0.02) [ADM ID: M62C63044C87BABT] - 2025/10/15 0:37:41 CET [2025/10/14 18:37:41 ET]
Table 'Sirio' 6-max Seat #1 is the button
Seat 1: Freddy15081988 (€1.93 in chips) 
Seat 2: Crock361 (€2.17 in chips) 
Seat 3: CarlaBBruni (€3.44 in chips) 
Seat 4: caduceus369 (€5.74 in chips) 
Seat 5: TheMule1454 (€1.86 in chips) 
Seat 6: Warterror90 (€3.32 in chips) 
Crock361: posts small blind €0.01
CarlaBBruni: posts big blind €0.02
*** HOLE CARDS ***
Dealt to caduceus369 [3h Ks]
caduceus369: folds 
TheMule1454: folds 
Warterror90: raises €0.04 to €0.06
Freddy15081988: calls €0.06
Crock361: folds 
CarlaBBruni: folds 
*** FLOP *** [9s 3s 7d]
Warterror90: checks 
Freddy15081988: bets €0.04
Warterror90: calls €0.04
*** TURN *** [9s 3s 7d] [8h]
Warterror90: checks 
Freddy15081988: bets €0.06
Warterror90: raises €0.12 to €0.18
Freddy15081988: folds 
Uncalled bet (€0.12) returned to Warterror90
Warterror90 collected €0.34 from pot
Warterror90: doesn't show hand 
*** SUMMARY ***
Total pot €0.35 | Rake €0.01 
Board [9s 3s 7d 8h]
Seat 1: Freddy15081988 (button) folded on the Turn
Seat 2: Crock361 (small blind) folded before Flop
Seat 3: CarlaBBruni (big blind) folded before Flop
Seat 4: caduceus369 folded before Flop (didn't bet)
Seat 5: TheMule1454 folded before Flop (didn't bet)
Seat 6: Warterror90 collected (€0.34)



PokerStars Zoom Hand #258128834164:  Hold'em No Limit (€0.01/€0.02) [ADM ID: M62C63044C87BABT] - 2025/10/15 0:38:09 CET [2025/10/14 18:38:09 ET]
Table 'Sirio' 6-max Seat #1 is the button
Seat 1: Vitto oolin (€0.71 in chips) 
Seat 2: caduceus369 (€5.72 in chips) 
Seat 3: 2PaperelaSgubio (€2.37 in chips) 
Seat 4: bv0360 (€1.42 in chips) 
Seat 5: 66lanci66 (€1.80 in chips) 
Seat 6: ADRIAN0_MEIS (€3.76 in chips) 
caduceus369: posts small blind €0.01
2PaperelaSgubio: posts big blind €0.02
*** HOLE CARDS ***
Dealt to caduceus369 [4c Qh]
bv0360: calls €0.02
66lanci66: raises €0.04 to €0.06
ADRIAN0_MEIS: folds 
Vitto oolin: folds 
caduceus369: folds 
2PaperelaSgubio: folds 
bv0360: calls €0.04
*** FLOP *** [2c 9d 6s]
bv0360: bets €0.02
66lanci66: folds 
Uncalled bet (€0.02) returned to bv0360
bv0360 collected €0.15 from pot
bv0360: doesn't show hand 
*** SUMMARY ***
Total pot €0.15 | Rake €0 
Board [2c 9d 6s]
Seat 1: Vitto oolin (button) folded before Flop (didn't bet)
Seat 2: caduceus369 (small blind) folded before Flop
Seat 3: 2PaperelaSgubio (big blind) folded before Flop
Seat 4: bv0360 collected (€0.15)
Seat 5: 66lanci66 folded on the Flop
Seat 6: ADRIAN0_MEIS folded before Flop (didn't bet)



PokerStars Zoom Hand #258128837146:  Hold'em No Limit (€0.01/€0.02) [ADM ID: M62C63044C87BABT] - 2025/10/15 0:38:24 CET [2025/10/14 18:38:24 ET]
Table 'Sirio' 6-max Seat #1 is the button
Seat 1: caduceus369 (€5.71 in chips) 
Seat 2: CarlaBBruni (€1.85 in chips) 
Seat 3: father2008 (€2.24 in chips) 
Seat 4: ADRIAN0_MEIS (€3.76 in chips) 
Seat 5: TheMule1454 (€1.85 in chips) 
Seat 6: mashallahh (€7.10 in chips) 
CarlaBBruni: posts small blind €0.01
father2008: posts big blind €0.02
*** HOLE CARDS ***
Dealt to caduceus369 [8h Ts]
ADRIAN0_MEIS: folds 
TheMule1454: raises €0.02 to €0.04
mashallahh: raises €0.16 to €0.20
caduceus369: folds 
CarlaBBruni: folds 
father2008: folds 
TheMule1454: folds 
Uncalled bet (€0.16) returned to mashallahh
mashallahh collected €0.11 from pot
mashallahh: doesn't show hand 
*** SUMMARY ***
Total pot €0.11 | Rake €0 
Seat 1: caduceus369 (button) folded before Flop (didn't bet)
Seat 2: CarlaBBruni (small blind) folded before Flop
Seat 3: father2008 (big blind) folded before Flop
Seat 4: ADRIAN0_MEIS folded before Flop (didn't bet)
Seat 5: TheMule1454 folded before Flop
Seat 6: mashallahh collected (€0.11)



PokerStars Zoom Hand #258128840298:  Hold'em No Limit (€0.01/€0.02) [ADM ID: M62C63044C87BABT] - 2025/10/15 0:38:39 CET [2025/10/14 18:38:39 ET]
Table 'Sirio' 6-max Seat #1 is the button
Seat 1: father2008 (€2.22 in chips) 
Seat 2: franck19621962 (€1.38 in chips) 
Seat 3: McSup (€3.95 in chips) 
Seat 4: mashallahh (€5.06 in chips) 
Seat 5: caduceus369 (€5.71 in chips) 
Seat 6: 2PaperelaSgubio (€2.98 in chips) 
franck19621962: posts small blind €0.01
McSup: posts big blind €0.02
*** HOLE CARDS ***
Dealt to caduceus369 [Th 7d]
mashallahh: folds 
caduceus369: folds 
2PaperelaSgubio: folds 
father2008: raises €0.04 to €0.06
franck19621962: folds 
McSup: folds 
Uncalled bet (€0.04) returned to father2008
father2008 collected €0.05 from pot
father2008: doesn't show hand 
*** SUMMARY ***
Total pot €0.05 | Rake €0 
Seat 1: father2008 (button) collected (€0.05)
Seat 2: franck19621962 (small blind) folded before Flop
Seat 3: McSup (big blind) folded before Flop
Seat 4: mashallahh folded before Flop (didn't bet)
Seat 5: caduceus369 folded before Flop (didn't bet)
Seat 6: 2PaperelaSgubio folded before Flop (didn't bet)



PokerStars Zoom Hand #258128844262:  Hold'em No Limit (€0.01/€0.02) [ADM ID: M62C63044C87BABT] - 2025/10/15 0:38:59 CET [2025/10/14 18:38:59 ET]
Table 'Sirio' 6-max Seat #1 is the button
Seat 1: Crock361 (€1.92 in chips) 
Seat 2: McSup (€3.93 in chips) 
Seat 3: caduceus369 (€5.70 in chips) 
Seat 4: TheMule1454 (€3.26 in chips) 
Seat 5: Begimon (€12.64 in chips) 
Seat 6: mashallahh (€8.15 in chips) 
McSup: posts small blind €0.01
caduceus369: posts big blind €0.02
*** HOLE CARDS ***
Dealt to caduceus369 [Kh 9s]
TheMule1454: folds 
Begimon: folds 
mashallahh: folds 
Crock361: folds 
McSup: folds 
Uncalled bet (€0.01) returned to caduceus369
caduceus369 collected €0.02 from pot
caduceus369: doesn't show hand 
*** SUMMARY ***
Total pot €0.02 | Rake €0 
Seat 1: Crock361 (button) folded before Flop (didn't bet)
Seat 2: McSup (small blind) folded before Flop
Seat 3: caduceus369 (big blind) collected (€0.02)
Seat 4: TheMule1454 folded before Flop (didn't bet)
Seat 5: Begimon folded before Flop (didn't bet)
Seat 6: mashallahh folded before Flop (didn't bet)



PokerStars Zoom Hand #258128842256:  Hold'em No Limit (€0.01/€0.02) [ADM ID: M62C63044C87BABT] - 2025/10/15 0:38:49 CET [2025/10/14 18:38:49 ET]
Table 'Sirio' 6-max Seat #1 is the button
Seat 1: Begimon (€12.64 in chips) 
Seat 2: mashallahh (€5.06 in chips) 
Seat 3: SebaRapy14 (€0.97 in chips) 
Seat 4: franck19621962 (€1.37 in chips) 
Seat 5: caduceus369 (€5.70 in chips) 
Seat 6: Catania838 (€2.08 in chips) 
mashallahh: posts small blind €0.01
SebaRapy14: posts big blind €0.02
*** HOLE CARDS ***
Dealt to caduceus369 [Jh 6c]
franck19621962: folds 
caduceus369: folds 
Catania838: calls €0.02
Begimon: folds 
mashallahh: folds 
SebaRapy14: checks 
*** FLOP *** [8c 7d 3c]
SebaRapy14: checks 
Catania838: bets €0.05
SebaRapy14: calls €0.05
*** TURN *** [8c 7d 3c] [Jc]
SebaRapy14: checks 
Catania838: checks 
*** RIVER *** [8c 7d 3c Jc] [Qc]
SebaRapy14: bets €0.10
Catania838: raises €0.35 to €0.45
SebaRapy14: calls €0.35
*** SHOW DOWN ***
Catania838: shows [Tc 9c] (a straight flush, Eight to Queen)
SebaRapy14: mucks hand 
Catania838 collected €1 from pot
*** SUMMARY ***
Total pot €1.05 | Rake €0.05 
Board [8c 7d 3c Jc Qc]
Seat 1: Begimon (button) folded before Flop (didn't bet)
Seat 2: mashallahh (small blind) folded before Flop
Seat 3: SebaRapy14 (big blind) mucked [Kc 7s]
Seat 4: franck19621962 folded before Flop (didn't bet)
Seat 5: caduceus369 folded before Flop (didn't bet)
Seat 6: Catania838 showed [Tc 9c] and won (€1) with a straight flush, Eight to Queen



PokerStars Zoom Hand #258128841506:  Hold'em No Limit (€0.01/€0.02) [ADM ID: M62C63044C87BABT] - 2025/10/15 0:38:45 CET [2025/10/14 18:38:45 ET]
Table 'Sirio' 6-max Seat #1 is the button
Seat 1: mashallahh (€8.15 in chips) 
Seat 2: caduceus369 (€5.71 in chips) 
Seat 3: TheMule1454 (€1.81 in chips) 
Seat 4: CIKO71131 (€0.79 in chips) 
Seat 5: franck19621962 (€1.37 in chips) 
Seat 6: maury999999 (€7.72 in chips) 
caduceus369: posts small blind €0.01
TheMule1454: posts big blind €0.02
*** HOLE CARDS ***
Dealt to caduceus369 [9s 7c]
CIKO71131: calls €0.02
franck19621962: folds 
maury999999: raises €0.06 to €0.08
mashallahh: folds 
caduceus369: folds 
TheMule1454: folds 
CIKO71131: calls €0.06
*** FLOP *** [9h 4c 8h]
CIKO71131: checks 
maury999999: bets €0.12
CIKO71131: calls €0.12
*** TURN *** [9h 4c 8h] [Qh]
CIKO71131: checks 
maury999999: checks 
*** RIVER *** [9h 4c 8h Qh] [2s]
CIKO71131: checks 
maury999999: checks 
*** SHOW DOWN ***
CIKO71131: shows [Ts 4s] (a pair of Fours)
maury999999: shows [8c Kc] (a pair of Eights)
maury999999 collected €0.41 from pot
*** SUMMARY ***
Total pot €0.43 | Rake €0.02 
Board [9h 4c 8h Qh 2s]
Seat 1: mashallahh (button) folded before Flop (didn't bet)
Seat 2: caduceus369 (small blind) folded before Flop
Seat 3: TheMule1454 (big blind) folded before Flop
Seat 4: CIKO71131 showed [Ts 4s] and lost with a pair of Fours
Seat 5: franck19621962 folded before Flop (didn't bet)
Seat 6: maury999999 showed [8c Kc] and won (€0.41) with a pair of Eights



PokerStars Zoom Hand #258128843269:  Hold'em No Limit (€0.01/€0.02) [ADM ID: M62C63044C87BABT] - 2025/10/15 0:38:54 CET [2025/10/14 18:38:54 ET]
Table 'Sirio' 6-max Seat #1 is the button
Seat 1: franck19621962 (€1.37 in chips) 
Seat 2: father2008 (€2.25 in chips) 
Seat 3: Catania838 (€2.37 in chips) 
Seat 4: mashallahh (€2.62 in chips) 
Seat 5: talpa890 (€2.28 in chips) 
Seat 6: caduceus369 (€5.70 in chips) 
father2008: posts small blind €0.01
Catania838: posts big blind €0.02
*** HOLE CARDS ***
Dealt to caduceus369 [9d 7c]
mashallahh: folds 
talpa890: calls €0.02
caduceus369: folds 
franck19621962: calls €0.02
father2008: calls €0.01
Catania838: checks 
*** FLOP *** [2h Qd Ac]
father2008: checks 
Catania838: checks 
talpa890: checks 
franck19621962: bets €0.04
father2008: folds 
Catania838: folds 
talpa890: calls €0.04
*** TURN *** [2h Qd Ac] [8d]
talpa890: checks 
franck19621962: bets €0.04
talpa890: calls €0.04
*** RIVER *** [2h Qd Ac 8d] [4d]
talpa890: checks 
franck19621962: checks 
*** SHOW DOWN ***
talpa890: shows [Js Kh] (high card Ace)
franck19621962: shows [Ad Qc] (two pair, Aces and Queens)
franck19621962 collected €0.23 from pot
*** SUMMARY ***
Total pot €0.24 | Rake €0.01 
Board [2h Qd Ac 8d 4d]
Seat 1: franck19621962 (button) showed [Ad Qc] and won (€0.23) with two pair, Aces and Queens
Seat 2: father2008 (small blind) folded on the Flop
Seat 3: Catania838 (big blind) folded on the Flop
Seat 4: mashallahh folded before Flop (didn't bet)
Seat 5: talpa890 showed [Js Kh] and lost with high card Ace
Seat 6: caduceus369 folded before Flop (didn't bet)



PokerStars Zoom Hand #258128848020:  Hold'em No Limit (€0.01/€0.02) [ADM ID: M62C63044C87BABT] - 2025/10/15 0:39:18 CET [2025/10/14 18:39:18 ET]
Table 'Sirio' 6-max Seat #1 is the button
Seat 1: TheMule1454 (€1.79 in chips) 
Seat 2: Warterror90 (€3.04 in chips) 
Seat 3: 66lanci66 (€1.72 in chips) 
Seat 4: caduceus369 (€5.71 in chips) 
Seat 5: mashallahh (€5.05 in chips) 
Seat 6: Crock361 (€1.99 in chips) 
Warterror90: posts small blind €0.01
66lanci66: posts big blind €0.02
*** HOLE CARDS ***
Dealt to caduceus369 [Jc Jd]
caduceus369: raises €0.04 to €0.06
mashallahh: folds 
Crock361: folds 
TheMule1454: folds 
Warterror90: raises €0.12 to €0.18
66lanci66: folds 
caduceus369: calls €0.12
*** FLOP *** [2c 5d 7h]
Warterror90: bets €0.14
caduceus369: calls €0.14
*** TURN *** [2c 5d 7h] [9h]
Warterror90: bets €0.28
caduceus369: calls €0.28
*** RIVER *** [2c 5d 7h 9h] [Ac]
Warterror90: checks 
caduceus369: checks 
*** SHOW DOWN ***
Warterror90: shows [Kh Ks] (a pair of Kings)
caduceus369: mucks hand 
Warterror90 collected €1.16 from pot
*** SUMMARY ***
Total pot €1.22 | Rake €0.06 
Board [2c 5d 7h 9h Ac]
Seat 1: TheMule1454 (button) folded before Flop (didn't bet)
Seat 2: Warterror90 (small blind) showed [Kh Ks] and won (€1.16) with a pair of Kings
Seat 3: 66lanci66 (big blind) folded before Flop
Seat 4: caduceus369 mucked [Jc Jd]
Seat 5: mashallahh folded before Flop (didn't bet)
Seat 6: Crock361 folded before Flop (didn't bet)



PokerStars Zoom Hand #258128863143:  Hold'em No Limit (€0.01/€0.02) [ADM ID: M62C63044C87BABT] - 2025/10/15 0:40:35 CET [2025/10/14 18:40:35 ET]
Table 'Sirio' 6-max Seat #1 is the button
Seat 1: caduceus369 (€5.11 in chips) 
Seat 2: Warterror90 (€3.84 in chips) 
Seat 3: maury999999 (€7.95 in chips) 
Seat 4: Crock361 (€1.99 in chips) 
Seat 5: mashallahh (€8.06 in chips) 
Seat 6: TheMule1454 (€1.78 in chips) 
Warterror90: posts small blind €0.01
maury999999: posts big blind €0.02
*** HOLE CARDS ***
Dealt to caduceus369 [6c 3c]
Crock361 has timed out
Crock361: folds 
mashallahh: folds 
TheMule1454: folds 
caduceus369: folds 
Warterror90: folds 
Uncalled bet (€0.01) returned to maury999999
maury999999 collected €0.02 from pot
maury999999: doesn't show hand 
*** SUMMARY ***
Total pot €0.02 | Rake €0 
Seat 1: caduceus369 (button) folded before Flop (didn't bet)
Seat 2: Warterror90 (small blind) folded before Flop
Seat 3: maury999999 (big blind) collected (€0.02)
Seat 4: Crock361 folded before Flop (didn't bet)
Seat 5: mashallahh folded before Flop (didn't bet)
Seat 6: TheMule1454 folded before Flop (didn't bet)



PokerStars Zoom Hand #258128865110:  Hold'em No Limit (€0.01/€0.02) [ADM ID: M62C63044C87BABT] - 2025/10/15 0:40:44 CET [2025/10/14 18:40:44 ET]
Table 'Sirio' 6-max Seat #1 is the button
Seat 1: mashallahh (€8.06 in chips) 
Seat 2: meteco79 (€0.96 in chips) 
Seat 3: TheMule1454 (€1.93 in chips) 
Seat 4: caduceus369 (€5.11 in chips) 
Seat 5: This Heat (€1.77 in chips) 
Seat 6: Warterror90 (€3.60 in chips) 
meteco79: posts small blind €0.01
TheMule1454: posts big blind €0.02
*** HOLE CARDS ***
Dealt to caduceus369 [4d 2d]
caduceus369: folds 
This Heat: raises €0.04 to €0.06
Warterror90: calls €0.06
mashallahh: folds 
meteco79: folds 
TheMule1454: folds 
*** FLOP *** [Jc As Th]
This Heat: bets €0.08
Warterror90: calls €0.08
*** TURN *** [Jc As Th] [3d]
This Heat: bets €0.15
Warterror90: folds 
Uncalled bet (€0.15) returned to This Heat
This Heat collected €0.30 from pot
This Heat: doesn't show hand 
*** SUMMARY ***
Total pot €0.31 | Rake €0.01 
Board [Jc As Th 3d]
Seat 1: mashallahh (button) folded before Flop (didn't bet)
Seat 2: meteco79 (small blind) folded before Flop
Seat 3: TheMule1454 (big blind) folded before Flop
Seat 4: caduceus369 folded before Flop (didn't bet)
Seat 5: This Heat collected (€0.30)
Seat 6: Warterror90 folded on the Turn



PokerStars Zoom Hand #258128866864:  Hold'em No Limit (€0.01/€0.02) [ADM ID: M62C63044C87BABT] - 2025/10/15 0:40:53 CET [2025/10/14 18:40:53 ET]
Table 'Sirio' 6-max Seat #1 is the button
Seat 1: 2PaperelaSgubio (€2.83 in chips) 
Seat 2: Freddy15081988 (€1.78 in chips) 
Seat 3: caduceus369 (€5.11 in chips) 
Seat 4: maury999999 (€7.96 in chips) 
Seat 5: TheMule1454 (€3.54 in chips) 
Seat 6: Crock361 (€2.03 in chips) 
Freddy15081988: posts small blind €0.01
caduceus369: posts big blind €0.02
*** HOLE CARDS ***
Dealt to caduceus369 [Ac 3h]
maury999999: folds 
TheMule1454: raises €0.06 to €0.08
Crock361: folds 
2PaperelaSgubio: folds 
Freddy15081988: calls €0.07
caduceus369: folds 
*** FLOP *** [Qd Ks 6d]
Freddy15081988: checks 
TheMule1454: bets €0.18
Freddy15081988: folds 
Uncalled bet (€0.18) returned to TheMule1454
TheMule1454 collected €0.18 from pot
TheMule1454: doesn't show hand 
*** SUMMARY ***
Total pot €0.18 | Rake €0 
Board [Qd Ks 6d]
Seat 1: 2PaperelaSgubio (button) folded before Flop (didn't bet)
Seat 2: Freddy15081988 (small blind) folded on the Flop
Seat 3: caduceus369 (big blind) folded before Flop
Seat 4: maury999999 folded before Flop (didn't bet)
Seat 5: TheMule1454 collected (€0.18)
Seat 6: Crock361 folded before Flop (didn't bet)



PokerStars Zoom Hand #258128875598:  Hold'em No Limit (€0.01/€0.02) [ADM ID: M62C63044C87BABT] - 2025/10/15 0:41:38 CET [2025/10/14 18:41:38 ET]
Table 'Sirio' 6-max Seat #1 is the button
Seat 1: meteco79 (€1.01 in chips) 
Seat 2: caduceus369 (€5.09 in chips) 
Seat 3: talpa890 (€2.13 in chips) 
Seat 4: SebaRapy14 (€3.02 in chips) 
Seat 5: Catania838 (€2.40 in chips) 
Seat 6: Freddy15081988 (€1.70 in chips) 
caduceus369: posts small blind €0.01
talpa890: posts big blind €0.02
*** HOLE CARDS ***
Dealt to caduceus369 [5c Qc]
SebaRapy14: folds 
Catania838: folds 
Freddy15081988: folds 
meteco79: folds 
caduceus369: folds 
Uncalled bet (€0.01) returned to talpa890
talpa890 collected €0.02 from pot
talpa890: doesn't show hand 
*** SUMMARY ***
Total pot €0.02 | Rake €0 
Seat 1: meteco79 (button) folded before Flop (didn't bet)
Seat 2: caduceus369 (small blind) folded before Flop
Seat 3: talpa890 (big blind) collected (€0.02)
Seat 4: SebaRapy14 folded before Flop (didn't bet)
Seat 5: Catania838 folded before Flop (didn't bet)
Seat 6: Freddy15081988 folded before Flop (didn't bet)



PokerStars Zoom Hand #258128872529:  Hold'em No Limit (€0.01/€0.02) [ADM ID: M62C63044C87BABT] - 2025/10/15 0:41:22 CET [2025/10/14 18:41:22 ET]
Table 'Sirio' 6-max Seat #1 is the button
Seat 1: caduceus369 (€5.09 in chips) 
Seat 2: 2PaperelaSgubio (€2.84 in chips) 
Seat 3: franck19621962 (€1.49 in chips) 
Seat 4: McSup (€2.68 in chips) 
Seat 5: gigiriver170 (€0.34 in chips) 
Seat 6: SebaRapy14 (€0.44 in chips) 
2PaperelaSgubio: posts small blind €0.01
franck19621962: posts big blind €0.02
*** HOLE CARDS ***
Dealt to caduceus369 [Qd 4s]
McSup: folds 
gigiriver170: folds 
SebaRapy14: folds 
caduceus369: folds 
2PaperelaSgubio: raises €0.04 to €0.06
franck19621962: folds 
Uncalled bet (€0.04) returned to 2PaperelaSgubio
2PaperelaSgubio collected €0.04 from pot
2PaperelaSgubio: doesn't show hand 
*** SUMMARY ***
Total pot €0.04 | Rake €0 
Seat 1: caduceus369 (button) folded before Flop (didn't bet)
Seat 2: 2PaperelaSgubio (small blind) collected (€0.04)
Seat 3: franck19621962 (big blind) folded before Flop
Seat 4: McSup folded before Flop (didn't bet)
Seat 5: gigiriver170 folded before Flop (didn't bet)
Seat 6: SebaRapy14 folded before Flop (didn't bet)



PokerStars Zoom Hand #258128874302:  Hold'em No Limit (€0.01/€0.02) [ADM ID: M62C63044C87BABT] - 2025/10/15 0:41:31 CET [2025/10/14 18:41:31 ET]
Table 'Sirio' 6-max Seat #1 is the button
Seat 1: CarlaBBruni (€4.21 in chips) 
Seat 2: mashallahh (€8.07 in chips) 
Seat 3: Crock361 (€1.84 in chips) 
Seat 4: Catania838 (€2.40 in chips) 
Seat 5: SebaRapy14 (€0.44 in chips) 
Seat 6: caduceus369 (€5.09 in chips) 
mashallahh: posts small blind €0.01
Crock361: posts big blind €0.02
*** HOLE CARDS ***
Dealt to caduceus369 [5c 7c]
Catania838: folds 
SebaRapy14: folds 
caduceus369: folds 
CarlaBBruni: raises €0.03 to €0.05
mashallahh: folds 
Crock361: raises €0.11 to €0.16
CarlaBBruni: folds 
Uncalled bet (€0.11) returned to Crock361
Crock361 collected €0.11 from pot
Crock361: doesn't show hand 
*** SUMMARY ***
Total pot €0.11 | Rake €0 
Seat 1: CarlaBBruni (button) folded before Flop
Seat 2: mashallahh (small blind) folded before Flop
Seat 3: Crock361 (big blind) collected (€0.11)
Seat 4: Catania838 folded before Flop (didn't bet)
Seat 5: SebaRapy14 folded before Flop (didn't bet)
Seat 6: caduceus369 folded before Flop (didn't bet)



PokerStars Zoom Hand #258128882049:  Hold'em No Limit (€0.01/€0.02) [ADM ID: M62C63044C87BABT] - 2025/10/15 0:42:10 CET [2025/10/14 18:42:10 ET]
Table 'Sirio' 6-max Seat #1 is the button
Seat 1: mashallahh (€7.39 in chips) 
Seat 2: McSup (€4.06 in chips) 
Seat 3: TheMule1454 (€1.68 in chips) 
Seat 4: caduceus369 (€5.07 in chips) 
Seat 5: Catania838 (€3.48 in chips) 
Seat 6: meteco79 (€1 in chips) 
McSup: posts small blind €0.01
TheMule1454: posts big blind €0.02
*** HOLE CARDS ***
Dealt to caduceus369 [4h Ac]
caduceus369: folds 
Catania838: folds 
meteco79: folds 
mashallahh: folds 
McSup: folds 
Uncalled bet (€0.01) returned to TheMule1454
TheMule1454 collected €0.02 from pot
TheMule1454: doesn't show hand 
*** SUMMARY ***
Total pot €0.02 | Rake €0 
Seat 1: mashallahh (button) folded before Flop (didn't bet)
Seat 2: McSup (small blind) folded before Flop
Seat 3: TheMule1454 (big blind) collected (€0.02)
Seat 4: caduceus369 folded before Flop (didn't bet)
Seat 5: Catania838 folded before Flop (didn't bet)
Seat 6: meteco79 folded before Flop (didn't bet)



PokerStars Zoom Hand #258128883385:  Hold'em No Limit (€0.01/€0.02) [ADM ID: M62C63044C87BABT] - 2025/10/15 0:42:17 CET [2025/10/14 18:42:17 ET]
Table 'Sirio' 6-max Seat #1 is the button
Seat 1: Warterror90 (€4.12 in chips) 
Seat 2: McSup (€2.65 in chips) 
Seat 3: caduceus369 (€5.07 in chips) 
Seat 4: SebaRapy14 (€2.99 in chips) 
Seat 5: meteco79 (€1 in chips) 
Seat 6: TheMule1454 (€2.27 in chips) 
McSup: posts small blind €0.01
caduceus369: posts big blind €0.02
*** HOLE CARDS ***
Dealt to caduceus369 [5d Ad]
SebaRapy14: folds 
meteco79: folds 
TheMule1454: folds 
Warterror90: folds 
McSup: folds 
Uncalled bet (€0.01) returned to caduceus369
caduceus369 collected €0.02 from pot
caduceus369: doesn't show hand 
*** SUMMARY ***
Total pot €0.02 | Rake €0 
Seat 1: Warterror90 (button) folded before Flop (didn't bet)
Seat 2: McSup (small blind) folded before Flop
Seat 3: caduceus369 (big blind) collected (€0.02)
Seat 4: SebaRapy14 folded before Flop (didn't bet)
Seat 5: meteco79 folded before Flop (didn't bet)
Seat 6: TheMule1454 folded before Flop (didn't bet)



PokerStars Zoom Hand #258128877485:  Hold'em No Limit (€0.01/€0.02) [ADM ID: M62C63044C87BABT] - 2025/10/15 0:41:47 CET [2025/10/14 18:41:47 ET]
Table 'Sirio' 6-max Seat #1 is the button
Seat 1: CIKO71131 (€0.67 in chips) 
Seat 2: ilteatro131 (€2.06 in chips) 
Seat 3: father2008 (€2.11 in chips) 
Seat 4: meteco79 (€1.01 in chips) 
Seat 5: caduceus369 (€5.08 in chips) 
Seat 6: mashallahh (€8.06 in chips) 
ilteatro131: posts small blind €0.01
father2008: posts big blind €0.02
*** HOLE CARDS ***
Dealt to caduceus369 [Th 3d]
meteco79: folds 
caduceus369: folds 
mashallahh: folds 
CIKO71131: calls €0.02
ilteatro131: calls €0.01
father2008: checks 
*** FLOP *** [Qd 3h 6h]
ilteatro131: checks 
father2008: checks 
CIKO71131: checks 
*** TURN *** [Qd 3h 6h] [Td]
ilteatro131: checks 
father2008: checks 
CIKO71131: checks 
*** RIVER *** [Qd 3h 6h Td] [Kd]
ilteatro131: checks 
father2008: bets €0.03
CIKO71131: folds 
ilteatro131: folds 
Uncalled bet (€0.03) returned to father2008
father2008 collected €0.06 from pot
father2008: doesn't show hand 
*** SUMMARY ***
Total pot €0.06 | Rake €0 
Board [Qd 3h 6h Td Kd]
Seat 1: CIKO71131 (button) folded on the River
Seat 2: ilteatro131 (small blind) folded on the River
Seat 3: father2008 (big blind) collected (€0.06)
Seat 4: meteco79 folded before Flop (didn't bet)
Seat 5: caduceus369 folded before Flop (didn't bet)
Seat 6: mashallahh folded before Flop (didn't bet)



PokerStars Zoom Hand #258128879244:  Hold'em No Limit (€0.01/€0.02) [ADM ID: M62C63044C87BABT] - 2025/10/15 0:41:56 CET [2025/10/14 18:41:56 ET]
Table 'Sirio' 6-max Seat #1 is the button
Seat 1: Catania838 (€3.48 in chips) 
Seat 2: caduceus369 (€5.08 in chips) 
Seat 3: maury999999 (€7.99 in chips) 
Seat 4: CarlaBBruni (€4.16 in chips) 
Seat 5: talpa890 (€2.14 in chips) 
Seat 6: 2PaperelaSgubio (€2.86 in chips) 
caduceus369: posts small blind €0.01
maury999999: posts big blind €0.02
*** HOLE CARDS ***
Dealt to caduceus369 [6s 5h]
CarlaBBruni: raises €0.02 to €0.04
talpa890: calls €0.04
2PaperelaSgubio: folds 
Catania838: folds 
caduceus369: folds 
maury999999: folds 
*** FLOP *** [3h 2d 2s]
CarlaBBruni: bets €0.04
talpa890: calls €0.04
*** TURN *** [3h 2d 2s] [3d]
CarlaBBruni: checks 
talpa890: bets €0.06
CarlaBBruni: folds 
Uncalled bet (€0.06) returned to talpa890
talpa890 collected €0.18 from pot
talpa890: doesn't show hand 
*** SUMMARY ***
Total pot €0.19 | Rake €0.01 
Board [3h 2d 2s 3d]
Seat 1: Catania838 (button) folded before Flop (didn't bet)
Seat 2: caduceus369 (small blind) folded before Flop
Seat 3: maury999999 (big blind) folded before Flop
Seat 4: CarlaBBruni folded on the Turn
Seat 5: talpa890 collected (€0.18)
Seat 6: 2PaperelaSgubio folded before Flop (didn't bet)



PokerStars Zoom Hand #258128885750:  Hold'em No Limit (€0.01/€0.02) [ADM ID: M62C63044C87BABT] - 2025/10/15 0:42:30 CET [2025/10/14 18:42:30 ET]
Table 'Sirio' 6-max Seat #1 is the button
Seat 1: Catania838 (€2.39 in chips) 
Seat 2: Warterror90 (€3.46 in chips) 
Seat 3: SebaRapy14 (€2.99 in chips) 
Seat 4: ilteatro131 (€2.04 in chips) 
Seat 5: caduceus369 (€5.08 in chips) 
Seat 6: CIKO71131 (€0.65 in chips) 
Warterror90: posts small blind €0.01
SebaRapy14: posts big blind €0.02
*** HOLE CARDS ***
Dealt to caduceus369 [Th Td]
ilteatro131: folds 
caduceus369: raises €0.04 to €0.06
CIKO71131: folds 
Catania838: folds 
Warterror90: folds 
SebaRapy14: folds 
Uncalled bet (€0.04) returned to caduceus369
caduceus369 collected €0.05 from pot
caduceus369: doesn't show hand 
*** SUMMARY ***
Total pot €0.05 | Rake €0 
Seat 1: Catania838 (button) folded before Flop (didn't bet)
Seat 2: Warterror90 (small blind) folded before Flop
Seat 3: SebaRapy14 (big blind) folded before Flop
Seat 4: ilteatro131 folded before Flop (didn't bet)
Seat 5: caduceus369 collected (€0.05)
Seat 6: CIKO71131 folded before Flop (didn't bet)



PokerStars Zoom Hand #258128889547:  Hold'em No Limit (€0.01/€0.02) [ADM ID: M62C63044C87BABT] - 2025/10/15 0:42:49 CET [2025/10/14 18:42:49 ET]
Table 'Sirio' 6-max Seat #1 is the button
Seat 1: McSup (€2.65 in chips) 
Seat 2: TheMule1454 (€3.64 in chips) 
Seat 3: Begimon (€12.33 in chips) 
Seat 4: mashallahh (€8.03 in chips) 
Seat 5: Crock361 (€1.92 in chips) 
Seat 6: caduceus369 (€5.11 in chips) 
TheMule1454: posts small blind €0.01
Begimon: posts big blind €0.02
*** HOLE CARDS ***
Dealt to caduceus369 [8c Kh]
mashallahh: raises €0.04 to €0.06
Crock361: folds 
caduceus369: folds 
McSup: folds 
TheMule1454: folds 
Begimon: folds 
Uncalled bet (€0.04) returned to mashallahh
mashallahh collected €0.05 from pot
mashallahh: doesn't show hand 
*** SUMMARY ***
Total pot €0.05 | Rake €0 
Seat 1: McSup (button) folded before Flop (didn't bet)
Seat 2: TheMule1454 (small blind) folded before Flop
Seat 3: Begimon (big blind) folded before Flop
Seat 4: mashallahh collected (€0.05)
Seat 5: Crock361 folded before Flop (didn't bet)
Seat 6: caduceus369 folded before Flop (didn't bet)



PokerStars Zoom Hand #258128890744:  Hold'em No Limit (€0.01/€0.02) [ADM ID: M62C63044C87BABT] - 2025/10/15 0:42:56 CET [2025/10/14 18:42:56 ET]
Table 'Sirio' 6-max Seat #1 is the button
Seat 1: franck19621962 (€1.64 in chips) 
Seat 2: 2PaperelaSgubio (€2.86 in chips) 
Seat 3: Catania838 (€2.39 in chips) 
Seat 4: caduceus369 (€5.11 in chips) 
Seat 5: McSup (€2.65 in chips) 
Seat 6: Crock361 (€1.92 in chips) 
2PaperelaSgubio: posts small blind €0.01
Catania838: posts big blind €0.02
*** HOLE CARDS ***
Dealt to caduceus369 [8c 4h]
caduceus369: folds 
McSup: folds 
Crock361: folds 
franck19621962: folds 
2PaperelaSgubio: raises €0.04 to €0.06
Catania838: folds 
Uncalled bet (€0.04) returned to 2PaperelaSgubio
2PaperelaSgubio collected €0.04 from pot
2PaperelaSgubio: doesn't show hand 
*** SUMMARY ***
Total pot €0.04 | Rake €0 
Seat 1: franck19621962 (button) folded before Flop (didn't bet)
Seat 2: 2PaperelaSgubio (small blind) collected (€0.04)
Seat 3: Catania838 (big blind) folded before Flop
Seat 4: caduceus369 folded before Flop (didn't bet)
Seat 5: McSup folded before Flop (didn't bet)
Seat 6: Crock361 folded before Flop (didn't bet)



PokerStars Zoom Hand #258128892154:  Hold'em No Limit (€0.01/€0.02) [ADM ID: M62C63044C87BABT] - 2025/10/15 0:43:03 CET [2025/10/14 18:43:03 ET]
Table 'Sirio' 6-max Seat #1 is the button
Seat 1: caduceus369 (€5.11 in chips) 
Seat 2: Crock361 (€2.01 in chips) 
Seat 3: Agnese84 (€2.38 in chips) 
Seat 4: talpa890 (€2.20 in chips) 
Seat 5: 2PaperelaSgubio (€2.76 in chips) 
Seat 6: Catania838 (€3.45 in chips) 
Crock361: posts small blind €0.01
Agnese84: posts big blind €0.02
*** HOLE CARDS ***
Dealt to caduceus369 [4s 4c]
talpa890: calls €0.02
2PaperelaSgubio: folds 
Catania838: folds 
caduceus369: calls €0.02
Crock361: folds 
Agnese84: checks 
*** FLOP *** [4d Qd 6s]
Agnese84: checks 
talpa890: checks 
caduceus369: checks 
*** TURN *** [4d Qd 6s] [7s]
Agnese84: checks 
talpa890: bets €0.02
caduceus369: calls €0.02
Agnese84: folds 
*** RIVER *** [4d Qd 6s 7s] [Jd]
talpa890: bets €0.02
caduceus369: raises €0.09 to €0.11
talpa890: folds 
Uncalled bet (€0.09) returned to caduceus369
caduceus369 collected €0.15 from pot
caduceus369: doesn't show hand 
*** SUMMARY ***
Total pot €0.15 | Rake €0 
Board [4d Qd 6s 7s Jd]
Seat 1: caduceus369 (button) collected (€0.15)
Seat 2: Crock361 (small blind) folded before Flop
Seat 3: Agnese84 (big blind) folded on the Turn
Seat 4: talpa890 folded on the River
Seat 5: 2PaperelaSgubio folded before Flop (didn't bet)
Seat 6: Catania838 folded before Flop (didn't bet)



PokerStars Zoom Hand #258128903870:  Hold'em No Limit (€0.01/€0.02) [ADM ID: M62C63044C87BABT] - 2025/10/15 0:44:05 CET [2025/10/14 18:44:05 ET]
Table 'Sirio' 6-max Seat #1 is the button
Seat 1: meteco79 (€1.17 in chips) 
Seat 2: caduceus369 (€5.20 in chips) 
Seat 3: ADRIAN0_MEIS (€3.43 in chips) 
Seat 4: Catania838 (€3.38 in chips) 
Seat 5: CarlaBBruni (€3.98 in chips) 
Seat 6: maury999999 (€8.34 in chips) 
caduceus369: posts small blind €0.01
ADRIAN0_MEIS: posts big blind €0.02
*** HOLE CARDS ***
Dealt to caduceus369 [4h Qd]
Catania838: folds 
maury999999 is disconnected 
CarlaBBruni: folds 
maury999999 has timed out while disconnected
maury999999: folds 
meteco79: folds 
caduceus369: folds 
Uncalled bet (€0.01) returned to ADRIAN0_MEIS
ADRIAN0_MEIS collected €0.02 from pot
ADRIAN0_MEIS: doesn't show hand 
*** SUMMARY ***
Total pot €0.02 | Rake €0 
Seat 1: meteco79 (button) folded before Flop (didn't bet)
Seat 2: caduceus369 (small blind) folded before Flop
Seat 3: ADRIAN0_MEIS (big blind) collected (€0.02)
Seat 4: Catania838 folded before Flop (didn't bet)
Seat 5: CarlaBBruni folded before Flop (didn't bet)
Seat 6: maury999999 folded before Flop (didn't bet)



PokerStars Zoom Hand #258128902503:  Hold'em No Limit (€0.01/€0.02) [ADM ID: M62C63044C87BABT] - 2025/10/15 0:43:58 CET [2025/10/14 18:43:58 ET]
Table 'Sirio' 6-max Seat #1 is the button
Seat 1: maury999999 (€4.71 in chips) 
Seat 2: Agnese84 (€2.36 in chips) 
Seat 3: aurelios2 (€9.30 in chips) 
Seat 4: bv0360 (€1.35 in chips) 
Seat 5: Warterror90 (€3.75 in chips) 
Seat 6: caduceus369 (€5.20 in chips) 
Agnese84: posts small blind €0.01
aurelios2: posts big blind €0.02
*** HOLE CARDS ***
Dealt to caduceus369 [9d Td]
bv0360: calls €0.02
Warterror90: raises €0.04 to €0.06
caduceus369: folds 
maury999999: folds 
Agnese84: calls €0.05
aurelios2: calls €0.04
bv0360: calls €0.04
*** FLOP *** [5s 5c Jc]
Agnese84: bets €0.12
aurelios2: folds 
bv0360: folds 
Warterror90: raises €0.18 to €0.30
Agnese84: calls €0.18
*** TURN *** [5s 5c Jc] [Qs]
Agnese84: checks 
Warterror90: checks 
*** RIVER *** [5s 5c Jc Qs] [2c]
Agnese84: bets €0.12
Warterror90: raises €0.58 to €0.70
Agnese84: folds 
Uncalled bet (€0.58) returned to Warterror90
Warterror90 collected €1.03 from pot
Warterror90: doesn't show hand 
*** SUMMARY ***
Total pot €1.08 | Rake €0.05 
Board [5s 5c Jc Qs 2c]
Seat 1: maury999999 (button) folded before Flop (didn't bet)
Seat 2: Agnese84 (small blind) folded on the River
Seat 3: aurelios2 (big blind) folded on the Flop
Seat 4: bv0360 folded on the Flop
Seat 5: Warterror90 collected (€1.03)
Seat 6: caduceus369 folded before Flop (didn't bet)



PokerStars Zoom Hand #258128909170:  Hold'em No Limit (€0.01/€0.02) [ADM ID: M62C63044C87BABT] - 2025/10/15 0:44:33 CET [2025/10/14 18:44:33 ET]
Table 'Sirio' 6-max Seat #1 is the button
Seat 1: Temait77728 (€0.83 in chips) 
Seat 2: bv0360 (€1.29 in chips) 
Seat 3: caduceus369 (€5.19 in chips) 
Seat 4: gigiriver170 (€0.84 in chips) 
Seat 5: Catania838 (€2.59 in chips) 
Seat 6: meteco79 (€1.14 in chips) 
bv0360: posts small blind €0.01
caduceus369: posts big blind €0.02
*** HOLE CARDS ***
Dealt to caduceus369 [9d 4s]
gigiriver170: raises €0.05 to €0.07
Catania838: calls €0.07
meteco79: folds 
Temait77728: folds 
bv0360: calls €0.06
caduceus369: folds 
*** FLOP *** [5d 7s 9c]
bv0360: checks 
gigiriver170: checks 
Catania838: bets €0.22
bv0360: calls €0.22
gigiriver170: folds 
*** TURN *** [5d 7s 9c] [2s]
bv0360: checks 
Catania838: checks 
*** RIVER *** [5d 7s 9c 2s] [3s]
bv0360: bets €0.32
Catania838: calls €0.32
*** SHOW DOWN ***
bv0360: shows [As Tc] (high card Ace)
Catania838: shows [6s 6h] (a pair of Sixes)
Catania838 collected €1.24 from pot
*** SUMMARY ***
Total pot €1.31 | Rake €0.07 
Board [5d 7s 9c 2s 3s]
Seat 1: Temait77728 (button) folded before Flop (didn't bet)
Seat 2: bv0360 (small blind) showed [As Tc] and lost with high card Ace
Seat 3: caduceus369 (big blind) folded before Flop
Seat 4: gigiriver170 folded on the Flop
Seat 5: Catania838 showed [6s 6h] and won (€1.24) with a pair of Sixes
Seat 6: meteco79 folded before Flop (didn't bet)



PokerStars Zoom Hand #258128915031:  Hold'em No Limit (€0.01/€0.02) [ADM ID: M62C63044C87BABT] - 2025/10/15 0:45:03 CET [2025/10/14 18:45:03 ET]
Table 'Sirio' 6-max Seat #1 is the button
Seat 1: Crock361 (€2.02 in chips) 
Seat 2: mashallahh (€2.87 in chips) 
Seat 3: CarlaBBruni (€3.95 in chips) 
Seat 4: aurelios2 (€9.02 in chips) 
Seat 5: caduceus369 (€5.17 in chips) 
Seat 6: Temait77728 (€0.80 in chips) 
mashallahh: posts small blind €0.01
CarlaBBruni: posts big blind €0.02
*** HOLE CARDS ***
Dealt to caduceus369 [2c Tc]
aurelios2: raises €0.06 to €0.08
caduceus369: folds 
Temait77728: folds 
Crock361: folds 
mashallahh: folds 
CarlaBBruni: folds 
Uncalled bet (€0.06) returned to aurelios2
aurelios2 collected €0.05 from pot
aurelios2: doesn't show hand 
*** SUMMARY ***
Total pot €0.05 | Rake €0 
Seat 1: Crock361 (button) folded before Flop (didn't bet)
Seat 2: mashallahh (small blind) folded before Flop
Seat 3: CarlaBBruni (big blind) folded before Flop
Seat 4: aurelios2 collected (€0.05)
Seat 5: caduceus369 folded before Flop (didn't bet)
Seat 6: Temait77728 folded before Flop (didn't bet)



PokerStars Zoom Hand #258128912737:  Hold'em No Limit (€0.01/€0.02) [ADM ID: M62C63044C87BABT] - 2025/10/15 0:44:51 CET [2025/10/14 18:44:51 ET]
Table 'Sirio' 6-max Seat #1 is the button
Seat 1: caduceus369 (€5.17 in chips) 
Seat 2: Alifatti (€0.65 in chips) 
Seat 3: franck19621962 (€1.50 in chips) 
Seat 4: CarlaBBruni (€3.95 in chips) 
Seat 5: CIKO71131 (€0.68 in chips) 
Seat 6: TheMule1454 (€3.59 in chips) 
Alifatti: posts small blind €0.01
franck19621962: posts big blind €0.02
*** HOLE CARDS ***
Dealt to caduceus369 [4h 5d]
CarlaBBruni: folds 
CIKO71131: calls €0.02
TheMule1454: raises €0.07 to €0.09
caduceus369: folds 
Alifatti: calls €0.08
franck19621962: calls €0.07
CIKO71131: calls €0.07
*** FLOP *** [7c 8s Js]
Alifatti: checks 
franck19621962: bets €0.02
CIKO71131: calls €0.02
TheMule1454: folds 
Alifatti: folds 
*** TURN *** [7c 8s Js] [Ad]
franck19621962: bets €0.02
CIKO71131: calls €0.02
*** RIVER *** [7c 8s Js Ad] [2s]
franck19621962: bets €0.02
CIKO71131: calls €0.02
*** SHOW DOWN ***
franck19621962: shows [9d Jd] (a pair of Jacks)
CIKO71131: mucks hand 
franck19621962 collected €0.46 from pot
*** SUMMARY ***
Total pot €0.48 | Rake €0.02 
Board [7c 8s Js Ad 2s]
Seat 1: caduceus369 (button) folded before Flop (didn't bet)
Seat 2: Alifatti (small blind) folded on the Flop
Seat 3: franck19621962 (big blind) showed [9d Jd] and won (€0.46) with a pair of Jacks
Seat 4: CarlaBBruni folded before Flop (didn't bet)
Seat 5: CIKO71131 mucked [4c 4d]
Seat 6: TheMule1454 folded on the Flop



PokerStars Zoom Hand #258128916536:  Hold'em No Limit (€0.01/€0.02) [ADM ID: M62C63044C87BABT] - 2025/10/15 0:45:11 CET [2025/10/14 18:45:11 ET]
Table 'Sirio' 6-max Seat #1 is the button
Seat 1: mashallahh (€2.86 in chips) 
Seat 2: 2PaperelaSgubio (€2.69 in chips) 
Seat 3: CarlaBBruni (€1.98 in chips) 
Seat 4: meteco79 (€1.12 in chips) 
Seat 5: caduceus369 (€5.17 in chips) 
Seat 6: McSup (€3.98 in chips) 
2PaperelaSgubio: posts small blind €0.01
CarlaBBruni: posts big blind €0.02
*** HOLE CARDS ***
Dealt to caduceus369 [Qc Js]
meteco79: calls €0.02
caduceus369: raises €0.04 to €0.06
McSup: folds 
mashallahh: folds 
2PaperelaSgubio: folds 
CarlaBBruni: folds 
meteco79: calls €0.04
*** FLOP *** [5d Jc Jh]
meteco79: bets €0.02
caduceus369: calls €0.02
*** TURN *** [5d Jc Jh] [4h]
meteco79: bets €0.02
caduceus369: calls €0.02
*** RIVER *** [5d Jc Jh 4h] [3c]
meteco79: bets €0.02
caduceus369: raises €0.08 to €0.10
meteco79: calls €0.08
*** SHOW DOWN ***
caduceus369: shows [Qc Js] (three of a kind, Jacks)
meteco79: mucks hand 
caduceus369 collected €0.41 from pot
*** SUMMARY ***
Total pot €0.43 | Rake €0.02 
Board [5d Jc Jh 4h 3c]
Seat 1: mashallahh (button) folded before Flop (didn't bet)
Seat 2: 2PaperelaSgubio (small blind) folded before Flop
Seat 3: CarlaBBruni (big blind) folded before Flop
Seat 4: meteco79 mucked [7s 5s]
Seat 5: caduceus369 showed [Qc Js] and won (€0.41) with three of a kind, Jacks
Seat 6: McSup folded before Flop (didn't bet)



PokerStars Zoom Hand #258128928642:  Hold'em No Limit (€0.01/€0.02) [ADM ID: M62C63044C87BABT] - 2025/10/15 0:46:14 CET [2025/10/14 18:46:14 ET]
Table 'Sirio' 6-max Seat #1 is the button
Seat 1: Crock361 (€1.77 in chips) 
Seat 2: mashallahh (€2.84 in chips) 
Seat 3: CarlaBBruni (€3.95 in chips) 
Seat 4: Catania838 (€3.19 in chips) 
Seat 5: McSup (€2.32 in chips) 
Seat 6: caduceus369 (€5.37 in chips) 
mashallahh: posts small blind €0.01
CarlaBBruni: posts big blind €0.02
*** HOLE CARDS ***
Dealt to caduceus369 [4s Qs]
Catania838: folds 
McSup: folds 
caduceus369: folds 
Crock361: raises €0.04 to €0.06
mashallahh: folds 
CarlaBBruni: folds 
Uncalled bet (€0.04) returned to Crock361
Crock361 collected €0.05 from pot
Crock361: doesn't show hand 
*** SUMMARY ***
Total pot €0.05 | Rake €0 
Seat 1: Crock361 (button) collected (€0.05)
Seat 2: mashallahh (small blind) folded before Flop
Seat 3: CarlaBBruni (big blind) folded before Flop
Seat 4: Catania838 folded before Flop (didn't bet)
Seat 5: McSup folded before Flop (didn't bet)
Seat 6: caduceus369 folded before Flop (didn't bet)



PokerStars Zoom Hand #258128925228:  Hold'em No Limit (€0.01/€0.02) [ADM ID: M62C63044C87BABT] - 2025/10/15 0:45:56 CET [2025/10/14 18:45:56 ET]
Table 'Sirio' 6-max Seat #1 is the button
Seat 1: Alifatti (€0.50 in chips) 
Seat 2: caduceus369 (€5.38 in chips) 
Seat 3: mashallahh (€6.78 in chips) 
Seat 4: Warterror90 (€3.96 in chips) 
Seat 5: TheMule1454 (€1.49 in chips) 
Seat 6: meteco79 (€0.92 in chips) 
caduceus369: posts small blind €0.01
mashallahh: posts big blind €0.02
*** HOLE CARDS ***
Dealt to caduceus369 [4h Js]
Warterror90: folds 
TheMule1454: raises €0.04 to €0.06
meteco79: calls €0.06
Alifatti: calls €0.06
caduceus369: folds 
mashallahh: folds 
*** FLOP *** [6c 7s 4s]
TheMule1454: checks 
meteco79: checks 
Alifatti: checks 
*** TURN *** [6c 7s 4s] [Ah]
TheMule1454: checks 
meteco79: bets €0.86 and is all-in
Alifatti: folds 
TheMule1454: folds 
Uncalled bet (€0.86) returned to meteco79
meteco79 collected €0.20 from pot
meteco79: doesn't show hand 
*** SUMMARY ***
Total pot €0.21 | Rake €0.01 
Board [6c 7s 4s Ah]
Seat 1: Alifatti (button) folded on the Turn
Seat 2: caduceus369 (small blind) folded before Flop
Seat 3: mashallahh (big blind) folded before Flop
Seat 4: Warterror90 folded before Flop (didn't bet)
Seat 5: TheMule1454 folded on the Turn
Seat 6: meteco79 collected (€0.20)



PokerStars Zoom Hand #258128929580:  Hold'em No Limit (€0.01/€0.02) [ADM ID: M62C63044C87BABT] - 2025/10/15 0:46:19 CET [2025/10/14 18:46:19 ET]
Table 'Sirio' 6-max Seat #1 is the button
Seat 1: This Heat (€2.21 in chips) 
Seat 2: McSup (€2.32 in chips) 
Seat 3: caduceus369 (€5.37 in chips) 
Seat 4: Warterror90 (€4.19 in chips) 
Seat 5: mashallahh (€2.83 in chips) 
Seat 6: TheMule1454 (€2.83 in chips) 
McSup: posts small blind €0.01
caduceus369: posts big blind €0.02
*** HOLE CARDS ***
Dealt to caduceus369 [Jc Qh]
Warterror90: folds 
mashallahh: folds 
TheMule1454: folds 
This Heat: folds 
McSup: raises €0.02 to €0.04
caduceus369: calls €0.02
*** FLOP *** [Jh Ad 2s]
McSup: bets €0.02
caduceus369: calls €0.02
*** TURN *** [Jh Ad 2s] [Ks]
McSup: checks 
caduceus369: bets €0.04
McSup: folds 
Uncalled bet (€0.04) returned to caduceus369
caduceus369 collected €0.12 from pot
caduceus369: doesn't show hand 
*** SUMMARY ***
Total pot €0.12 | Rake €0 
Board [Jh Ad 2s Ks]
Seat 1: This Heat (button) folded before Flop (didn't bet)
Seat 2: McSup (small blind) folded on the Turn
Seat 3: caduceus369 (big blind) collected (€0.12)
Seat 4: Warterror90 folded before Flop (didn't bet)
Seat 5: mashallahh folded before Flop (didn't bet)
Seat 6: TheMule1454 folded before Flop (didn't bet)



PokerStars Zoom Hand #258128939131:  Hold'em No Limit (€0.01/€0.02) [ADM ID: M62C63044C87BABT] - 2025/10/15 0:47:08 CET [2025/10/14 18:47:08 ET]
Table 'Sirio' 6-max Seat #1 is the button
Seat 1: caduceus369 (€5.43 in chips) 
Seat 2: mashallahh (€8.45 in chips) 
Seat 3: 2PaperelaSgubio (€2.59 in chips) 
Seat 4: SebaRapy14 (€3.24 in chips) 
Seat 5: Warterror90 (€4.12 in chips) 
Seat 6: TheMule1454 (€2.77 in chips) 
mashallahh: posts small blind €0.01
2PaperelaSgubio: posts big blind €0.02
*** HOLE CARDS ***
Dealt to caduceus369 [Ah 6s]
SebaRapy14: folds 
Warterror90: folds 
TheMule1454: folds 
caduceus369: raises €0.04 to €0.06
mashallahh: folds 
2PaperelaSgubio: folds 
Uncalled bet (€0.04) returned to caduceus369
caduceus369 collected €0.05 from pot
caduceus369: doesn't show hand 
*** SUMMARY ***
Total pot €0.05 | Rake €0 
Seat 1: caduceus369 (button) collected (€0.05)
Seat 2: mashallahh (small blind) folded before Flop
Seat 3: 2PaperelaSgubio (big blind) folded before Flop
Seat 4: SebaRapy14 folded before Flop (didn't bet)
Seat 5: Warterror90 folded before Flop (didn't bet)
Seat 6: TheMule1454 folded before Flop (didn't bet)



PokerStars Zoom Hand #258128937165:  Hold'em No Limit (€0.01/€0.02) [ADM ID: M62C63044C87BABT] - 2025/10/15 0:46:58 CET [2025/10/14 18:46:58 ET]
Table 'Sirio' 6-max Seat #1 is the button
Seat 1: Temait77728 (€0.78 in chips) 
Seat 2: CarlaBBruni (€4.03 in chips) 
Seat 3: bv0360 (€0.57 in chips) 
Seat 4: caduceus369 (€5.43 in chips) 
Seat 5: Crock361 (€2.21 in chips) 
Seat 6: mashallahh (€5.57 in chips) 
CarlaBBruni: posts small blind €0.01
bv0360: posts big blind €0.02
*** HOLE CARDS ***
Dealt to caduceus369 [4d 4h]
caduceus369: folds 
Crock361: raises €0.04 to €0.06
mashallahh: folds 
Temait77728: folds 
CarlaBBruni: folds 
bv0360: calls €0.04
*** FLOP *** [6h 2s Td]
bv0360: bets €0.02
Crock361: calls €0.02
*** TURN *** [6h 2s Td] [5d]
bv0360: bets €0.02
Crock361: raises €0.21 to €0.23
bv0360: folds 
Uncalled bet (€0.21) returned to Crock361
Crock361 collected €0.20 from pot
Crock361: doesn't show hand 
*** SUMMARY ***
Total pot €0.21 | Rake €0.01 
Board [6h 2s Td 5d]
Seat 1: Temait77728 (button) folded before Flop (didn't bet)
Seat 2: CarlaBBruni (small blind) folded before Flop
Seat 3: bv0360 (big blind) folded on the Turn
Seat 4: caduceus369 folded before Flop (didn't bet)
Seat 5: Crock361 collected (€0.20)
Seat 6: mashallahh folded before Flop (didn't bet)



PokerStars Zoom Hand #258128944750:  Hold'em No Limit (€0.01/€0.02) [ADM ID: M62C63044C87BABT] - 2025/10/15 0:47:37 CET [2025/10/14 18:47:37 ET]
Table 'Sirio' 6-max Seat #1 is the button
Seat 1: Crock361 (€1.97 in chips) 
Seat 2: TheMule1454 (€3.50 in chips) 
Seat 3: 2PaperelaSgubio (€2.58 in chips) 
Seat 4: Alifatti (€0.55 in chips) 
Seat 5: mashallahh (€5.56 in chips) 
Seat 6: caduceus369 (€5.46 in chips) 
TheMule1454: posts small blind €0.01
2PaperelaSgubio: posts big blind €0.02
*** HOLE CARDS ***
Dealt to caduceus369 [Ks 2d]
Alifatti: folds 
mashallahh: folds 
caduceus369: folds 
Crock361: folds 
TheMule1454: folds 
Uncalled bet (€0.01) returned to 2PaperelaSgubio
2PaperelaSgubio collected €0.02 from pot
2PaperelaSgubio: doesn't show hand 
*** SUMMARY ***
Total pot €0.02 | Rake €0 
Seat 1: Crock361 (button) folded before Flop (didn't bet)
Seat 2: TheMule1454 (small blind) folded before Flop
Seat 3: 2PaperelaSgubio (big blind) collected (€0.02)
Seat 4: Alifatti folded before Flop (didn't bet)
Seat 5: mashallahh folded before Flop (didn't bet)
Seat 6: caduceus369 folded before Flop (didn't bet)



PokerStars Zoom Hand #258128945573:  Hold'em No Limit (€0.01/€0.02) [ADM ID: M62C63044C87BABT] - 2025/10/15 0:47:42 CET [2025/10/14 18:47:42 ET]
Table 'Sirio' 6-max Seat #1 is the button
Seat 1: Freddy15081988 (€1.03 in chips) 
Seat 2: McSup (€3.88 in chips) 
Seat 3: mashallahh (€5.56 in chips) 
Seat 4: caduceus369 (€5.46 in chips) 
Seat 5: father2008 (€2.15 in chips) 
Seat 6: Crock361 (€1.97 in chips) 
McSup: posts small blind €0.01
mashallahh: posts big blind €0.02
*** HOLE CARDS ***
Dealt to caduceus369 [5s Th]
caduceus369: folds 
father2008: folds 
Crock361: folds 
Freddy15081988: folds 
McSup: raises €0.02 to €0.04
mashallahh: folds 
Uncalled bet (€0.02) returned to McSup
McSup collected €0.04 from pot
McSup: doesn't show hand 
*** SUMMARY ***
Total pot €0.04 | Rake €0 
Seat 1: Freddy15081988 (button) folded before Flop (didn't bet)
Seat 2: McSup (small blind) collected (€0.04)
Seat 3: mashallahh (big blind) folded before Flop
Seat 4: caduceus369 folded before Flop (didn't bet)
Seat 5: father2008 folded before Flop (didn't bet)
Seat 6: Crock361 folded before Flop (didn't bet)



PokerStars Zoom Hand #258128947662:  Hold'em No Limit (€0.01/€0.02) [ADM ID: M62C63044C87BABT] - 2025/10/15 0:47:52 CET [2025/10/14 18:47:52 ET]
Table 'Sirio' 6-max Seat #1 is the button
Seat 1: Crock361 (€2.30 in chips) 
Seat 2: mashallahh (€3 in chips) 
Seat 3: caduceus369 (€5.46 in chips) 
Seat 4: meteco79 (€1.30 in chips) 
Seat 5: father2008 (€2.15 in chips) 
Seat 6: 2PaperelaSgubio (€2.59 in chips) 
mashallahh: posts small blind €0.01
caduceus369: posts big blind €0.02
*** HOLE CARDS ***
Dealt to caduceus369 [9c Jh]
meteco79: calls €0.02
father2008: folds 
2PaperelaSgubio: folds 
Crock361: folds 
mashallahh: folds 
caduceus369: checks 
*** FLOP *** [Jd Kh 2d]
caduceus369: checks 
meteco79: checks 
*** TURN *** [Jd Kh 2d] [2s]
caduceus369: bets €0.02
meteco79: folds 
Uncalled bet (€0.02) returned to caduceus369
caduceus369 collected €0.05 from pot
caduceus369: doesn't show hand 
*** SUMMARY ***
Total pot €0.05 | Rake €0 
Board [Jd Kh 2d 2s]
Seat 1: Crock361 (button) folded before Flop (didn't bet)
Seat 2: mashallahh (small blind) folded before Flop
Seat 3: caduceus369 (big blind) collected (€0.05)
Seat 4: meteco79 folded on the Turn
Seat 5: father2008 folded before Flop (didn't bet)
Seat 6: 2PaperelaSgubio folded before Flop (didn't bet)



PokerStars Zoom Hand #258128943245:  Hold'em No Limit (€0.01/€0.02) [ADM ID: M62C63044C87BABT] - 2025/10/15 0:47:29 CET [2025/10/14 18:47:29 ET]
Table 'Sirio' 6-max Seat #1 is the button
Seat 1: Crock361 (€1.99 in chips) 
Seat 2: This Heat (€1.97 in chips) 
Seat 3: TheMule1454 (€0.90 in chips) 
Seat 4: mashallahh (€5.57 in chips) 
Seat 5: caduceus369 (€5.46 in chips) 
Seat 6: CIKO71131 (€0.93 in chips) 
This Heat: posts small blind €0.01
TheMule1454: posts big blind €0.02
*** HOLE CARDS ***
Dealt to caduceus369 [7c Ah]
mashallahh: folds 
caduceus369: folds 
CIKO71131: calls €0.02
Crock361: raises €0.07 to €0.09
This Heat: calls €0.08
TheMule1454: folds 
CIKO71131: calls €0.07
*** FLOP *** [Ad 3s 5s]
This Heat: checks 
CIKO71131: checks 
Crock361: checks 
*** TURN *** [Ad 3s 5s] [Th]
This Heat: bets €0.14
CIKO71131: folds 
Crock361: calls €0.14
*** RIVER *** [Ad 3s 5s Th] [Jc]
This Heat: bets €0.38
Crock361: folds 
Uncalled bet (€0.38) returned to This Heat
This Heat collected €0.54 from pot
This Heat: doesn't show hand 
*** SUMMARY ***
Total pot €0.57 | Rake €0.03 
Board [Ad 3s 5s Th Jc]
Seat 1: Crock361 (button) folded on the River
Seat 2: This Heat (small blind) collected (€0.54)
Seat 3: TheMule1454 (big blind) folded before Flop
Seat 4: mashallahh folded before Flop (didn't bet)
Seat 5: caduceus369 folded before Flop (didn't bet)
Seat 6: CIKO71131 folded on the Turn



PokerStars Zoom Hand #258128953349:  Hold'em No Limit (€0.01/€0.02) [ADM ID: M62C63044C87BABT] - 2025/10/15 0:48:23 CET [2025/10/14 18:48:23 ET]
Table 'Sirio' 6-max Seat #1 is the button
Seat 1: caduceus369 (€5.48 in chips) 
Seat 2: Freddy15081988 (€1.01 in chips) 
Seat 3: franck19621962 (€1.91 in chips) 
Seat 4: CarlaBBruni (€1.94 in chips) 
Seat 5: meteco79 (€1.26 in chips) 
Seat 6: father2008 (€2.12 in chips) 
Freddy15081988: posts small blind €0.01
franck19621962: posts big blind €0.02
*** HOLE CARDS ***
Dealt to caduceus369 [Jh Kc]
CarlaBBruni: raises €0.02 to €0.04
meteco79: folds 
father2008: calls €0.04
caduceus369: raises €0.14 to €0.18
Freddy15081988: folds 
franck19621962: folds 
CarlaBBruni: folds 
father2008: folds 
Uncalled bet (€0.14) returned to caduceus369
caduceus369 collected €0.15 from pot
caduceus369: doesn't show hand 
*** SUMMARY ***
Total pot €0.15 | Rake €0 
Seat 1: caduceus369 (button) collected (€0.15)
Seat 2: Freddy15081988 (small blind) folded before Flop
Seat 3: franck19621962 (big blind) folded before Flop
Seat 4: CarlaBBruni folded before Flop
Seat 5: meteco79 folded before Flop (didn't bet)
Seat 6: father2008 folded before Flop



PokerStars Zoom Hand #258128957273:  Hold'em No Limit (€0.01/€0.02) [ADM ID: M62C63044C87BABT] - 2025/10/15 0:48:44 CET [2025/10/14 18:48:44 ET]
Table 'Sirio' 6-max Seat #1 is the button
Seat 1: mashallahh (€6.88 in chips) 
Seat 2: Catania838 (€4.10 in chips) 
Seat 3: Warterror90 (€4.17 in chips) 
Seat 4: Crock361 (€2.28 in chips) 
Seat 5: caduceus369 (€5.59 in chips) 
Seat 6: McSup (€1.35 in chips) 
Catania838: posts small blind €0.01
Warterror90: posts big blind €0.02
*** HOLE CARDS ***
Dealt to caduceus369 [3h Td]
Crock361: folds 
caduceus369: folds 
McSup: folds 
mashallahh: folds 
Catania838: folds 
Uncalled bet (€0.01) returned to Warterror90
Warterror90 collected €0.02 from pot
Warterror90: doesn't show hand 
*** SUMMARY ***
Total pot €0.02 | Rake €0 
Seat 1: mashallahh (button) folded before Flop (didn't bet)
Seat 2: Catania838 (small blind) folded before Flop
Seat 3: Warterror90 (big blind) collected (€0.02)
Seat 4: Crock361 folded before Flop (didn't bet)
Seat 5: caduceus369 folded before Flop (didn't bet)
Seat 6: McSup folded before Flop (didn't bet)



PokerStars Zoom Hand #258128951659:  Hold'em No Limit (€0.01/€0.02) [ADM ID: M62C63044C87BABT] - 2025/10/15 0:48:14 CET [2025/10/14 18:48:14 ET]
Table 'Sirio' 6-max Seat #1 is the button
Seat 1: CarlaBBruni (€1.94 in chips) 
Seat 2: caduceus369 (€5.49 in chips) 
Seat 3: TheMule1454 (€2.75 in chips) 
Seat 4: Temait77728 (€0.80 in chips) 
Seat 5: CIKO71131 (€0.84 in chips) 
Seat 6: mashallahh (€2.99 in chips) 
caduceus369: posts small blind €0.01
TheMule1454: posts big blind €0.02
*** HOLE CARDS ***
Dealt to caduceus369 [Qs 9h]
Temait77728: raises €0.04 to €0.06
CIKO71131: calls €0.06
mashallahh: raises €0.18 to €0.24
CarlaBBruni: folds 
caduceus369: folds 
TheMule1454: folds 
Temait77728: calls €0.18
CIKO71131: folds 
*** FLOP *** [4c Jd 6h]
Temait77728: bets €0.56 and is all-in
mashallahh: folds 
Uncalled bet (€0.56) returned to Temait77728
Temait77728 collected €0.54 from pot
Temait77728: doesn't show hand 
*** SUMMARY ***
Total pot €0.57 | Rake €0.03 
Board [4c Jd 6h]
Seat 1: CarlaBBruni (button) folded before Flop (didn't bet)
Seat 2: caduceus369 (small blind) folded before Flop
Seat 3: TheMule1454 (big blind) folded before Flop
Seat 4: Temait77728 collected (€0.54)
Seat 5: CIKO71131 folded before Flop
Seat 6: mashallahh folded on the Flop



PokerStars Zoom Hand #258128958608:  Hold'em No Limit (€0.01/€0.02) [ADM ID: M62C63044C87BABT] - 2025/10/15 0:48:51 CET [2025/10/14 18:48:51 ET]
Table 'Sirio' 6-max Seat #1 is the button
Seat 1: Crock361 (€2.28 in chips) 
Seat 2: CarlaBBruni (€1.88 in chips) 
Seat 3: TheMule1454 (€0.87 in chips) 
Seat 4: Catania838 (€4.09 in chips) 
Seat 5: Agnese84 (€1.46 in chips) 
Seat 6: caduceus369 (€5.59 in chips) 
CarlaBBruni: posts small blind €0.01
TheMule1454: posts big blind €0.02
*** HOLE CARDS ***
Dealt to caduceus369 [Ts 4s]
Catania838: calls €0.02
Agnese84: calls €0.02
caduceus369: folds 
Crock361: folds 
CarlaBBruni: folds 
TheMule1454: checks 
*** FLOP *** [Js Kh Ks]
TheMule1454: bets €0.07
Catania838: calls €0.07
Agnese84: folds 
*** TURN *** [Js Kh Ks] [8s]
TheMule1454: bets €0.20
Catania838: folds 
Uncalled bet (€0.20) returned to TheMule1454
TheMule1454 collected €0.20 from pot
TheMule1454: doesn't show hand 
*** SUMMARY ***
Total pot €0.21 | Rake €0.01 
Board [Js Kh Ks 8s]
Seat 1: Crock361 (button) folded before Flop (didn't bet)
Seat 2: CarlaBBruni (small blind) folded before Flop
Seat 3: TheMule1454 (big blind) collected (€0.20)
Seat 4: Catania838 folded on the Turn
Seat 5: Agnese84 folded on the Flop
Seat 6: caduceus369 folded before Flop (didn't bet)



PokerStars Zoom Hand #258128963478:  Hold'em No Limit (€0.01/€0.02) [ADM ID: M62C63044C87BABT] - 2025/10/15 0:49:17 CET [2025/10/14 18:49:17 ET]
Table 'Sirio' 6-max Seat #1 is the button
Seat 1: 2PaperelaSgubio (€1.99 in chips) 
Seat 2: caduceus369 (€5.57 in chips) 
Seat 3: TheBullOfPoker (€2 in chips) 
Seat 4: meteco79 (€1.24 in chips) 
Seat 5: Catania838 (€4 in chips) 
Seat 6: Warterror90 (€3.82 in chips) 
caduceus369: posts small blind €0.01
TheBullOfPoker: posts big blind €0.02
*** HOLE CARDS ***
Dealt to caduceus369 [Tc 3c]
meteco79: calls €0.02
Catania838: folds 
Warterror90: folds 
2PaperelaSgubio: folds 
caduceus369: folds 
TheBullOfPoker: checks 
*** FLOP *** [Qd 5h Ac]
TheBullOfPoker: checks 
meteco79: checks 
*** TURN *** [Qd 5h Ac] [9s]
TheBullOfPoker: checks 
meteco79: checks 
*** RIVER *** [Qd 5h Ac 9s] [7d]
TheBullOfPoker: checks 
meteco79: bets €0.02
TheBullOfPoker: calls €0.02
*** SHOW DOWN ***
meteco79: shows [Jc Jd] (a pair of Jacks)
TheBullOfPoker: mucks hand 
meteco79 collected €0.09 from pot
*** SUMMARY ***
Total pot €0.09 | Rake €0 
Board [Qd 5h Ac 9s 7d]
Seat 1: 2PaperelaSgubio (button) folded before Flop (didn't bet)
Seat 2: caduceus369 (small blind) folded before Flop
Seat 3: TheBullOfPoker (big blind) mucked [4s 5d]
Seat 4: meteco79 showed [Jc Jd] and won (€0.09) with a pair of Jacks
Seat 5: Catania838 folded before Flop (didn't bet)
Seat 6: Warterror90 folded before Flop (didn't bet)



PokerStars Zoom Hand #258128959539:  Hold'em No Limit (€0.01/€0.02) [ADM ID: M62C63044C87BABT] - 2025/10/15 0:48:56 CET [2025/10/14 18:48:56 ET]
Table 'Sirio' 6-max Seat #1 is the button
Seat 1: SebaRapy14 (€3.41 in chips) 
Seat 2: Warterror90 (€4.18 in chips) 
Seat 3: caduceus369 (€5.59 in chips) 
Seat 4: ADRIAN0_MEIS (€3.62 in chips) 
Seat 5: CarlaBBruni (€1.87 in chips) 
Seat 6: mashallahh (€6.87 in chips) 
Warterror90: posts small blind €0.01
caduceus369: posts big blind €0.02
*** HOLE CARDS ***
Dealt to caduceus369 [3d Js]
ADRIAN0_MEIS: raises €0.05 to €0.07
CarlaBBruni: folds 
mashallahh: folds 
SebaRapy14: folds 
Warterror90: calls €0.06
caduceus369: folds 
*** FLOP *** [Qd 6s 3c]
Warterror90: bets €0.06
ADRIAN0_MEIS: raises €0.24 to €0.30
Warterror90: calls €0.24
*** TURN *** [Qd 6s 3c] [6d]
Warterror90: checks 
ADRIAN0_MEIS: bets €0.40
Warterror90: calls €0.40
*** RIVER *** [Qd 6s 3c 6d] [2h]
Warterror90: checks 
ADRIAN0_MEIS: bets €0.81
Warterror90: calls €0.81
*** SHOW DOWN ***
ADRIAN0_MEIS: shows [Kd Kc] (two pair, Kings and Sixes)
Warterror90: mucks hand 
ADRIAN0_MEIS collected €3.01 from pot
*** SUMMARY ***
Total pot €3.18 | Rake €0.17 
Board [Qd 6s 3c 6d 2h]
Seat 1: SebaRapy14 (button) folded before Flop (didn't bet)
Seat 2: Warterror90 (small blind) mucked [8s Qs]
Seat 3: caduceus369 (big blind) folded before Flop
Seat 4: ADRIAN0_MEIS showed [Kd Kc] and won (€3.01) with two pair, Kings and Sixes
Seat 5: CarlaBBruni folded before Flop (didn't bet)
Seat 6: mashallahh folded before Flop (didn't bet)



PokerStars Zoom Hand #258128966216:  Hold'em No Limit (€0.01/€0.02) [ADM ID: M62C63044C87BABT] - 2025/10/15 0:49:31 CET [2025/10/14 18:49:31 ET]
Table 'Sirio' 6-max Seat #1 is the button
Seat 1: caduceus369 (€5.56 in chips) 
Seat 2: Trezvenik93 (€2 in chips) 
Seat 3: This Heat (€1.38 in chips) 
Seat 4: CarlaBBruni (€4.54 in chips) 
Seat 5: TheMule1454 (€3.05 in chips) 
Seat 6: franck19621962 (€1.83 in chips) 
Trezvenik93: posts small blind €0.01
This Heat: posts big blind €0.02
*** HOLE CARDS ***
Dealt to caduceus369 [5h 7c]
CarlaBBruni: folds 
TheMule1454: folds 
franck19621962: folds 
caduceus369: folds 
Trezvenik93: raises €0.03 to €0.05
This Heat: calls €0.03
*** FLOP *** [9s 5s 2h]
Trezvenik93: bets €0.04
This Heat: calls €0.04
*** TURN *** [9s 5s 2h] [3d]
Trezvenik93: checks 
This Heat: checks 
*** RIVER *** [9s 5s 2h 3d] [8d]
Trezvenik93: checks 
This Heat: checks 
*** SHOW DOWN ***
Trezvenik93: shows [Kc Ac] (high card Ace)
This Heat: shows [2d As] (a pair of Deuces)
This Heat collected €0.18 from pot
*** SUMMARY ***
Total pot €0.18 | Rake €0 
Board [9s 5s 2h 3d 8d]
Seat 1: caduceus369 (button) folded before Flop (didn't bet)
Seat 2: Trezvenik93 (small blind) showed [Kc Ac] and lost with high card Ace
Seat 3: This Heat (big blind) showed [2d As] and won (€0.18) with a pair of Deuces
Seat 4: CarlaBBruni folded before Flop (didn't bet)
Seat 5: TheMule1454 folded before Flop (didn't bet)
Seat 6: franck19621962 folded before Flop (didn't bet)



PokerStars Zoom Hand #258128966935:  Hold'em No Limit (€0.01/€0.02) [ADM ID: M62C63044C87BABT] - 2025/10/15 0:49:35 CET [2025/10/14 18:49:35 ET]
Table 'Sirio' 6-max Seat #1 is the button
Seat 1: Agnese84 (€1.39 in chips) 
Seat 2: CarlaBBruni (€4.54 in chips) 
Seat 3: EasyToRule (€2 in chips) 
Seat 4: caduceus369 (€5.56 in chips) 
Seat 5: franck19621962 (€1.83 in chips) 
Seat 6: Crock361 (€2.21 in chips) 
CarlaBBruni: posts small blind €0.01
EasyToRule: posts big blind €0.02
*** HOLE CARDS ***
Dealt to caduceus369 [7h 4c]
caduceus369: folds 
franck19621962: folds 
Crock361: folds 
Agnese84: calls €0.02
CarlaBBruni: folds 
EasyToRule: checks 
*** FLOP *** [Kc Ks 8c]
EasyToRule: checks 
Agnese84: checks 
*** TURN *** [Kc Ks 8c] [4s]
EasyToRule: checks 
Agnese84: bets €0.05
EasyToRule: folds 
Uncalled bet (€0.05) returned to Agnese84
Agnese84 collected €0.05 from pot
Agnese84: doesn't show hand 
*** SUMMARY ***
Total pot €0.05 | Rake €0 
Board [Kc Ks 8c 4s]
Seat 1: Agnese84 (button) collected (€0.05)
Seat 2: CarlaBBruni (small blind) folded before Flop
Seat 3: EasyToRule (big blind) folded on the Turn
Seat 4: caduceus369 folded before Flop (didn't bet)
Seat 5: franck19621962 folded before Flop (didn't bet)
Seat 6: Crock361 folded before Flop (didn't bet)



PokerStars Zoom Hand #258128967639:  Hold'em No Limit (€0.01/€0.02) [ADM ID: M62C63044C87BABT] - 2025/10/15 0:49:39 CET [2025/10/14 18:49:39 ET]
Table 'Sirio' 6-max Seat #1 is the button
Seat 1: CarlaBBruni (€4.53 in chips) 
Seat 2: gigiriver170 (€1.13 in chips) 
Seat 3: miridersa (€0.80 in chips) 
Seat 4: caduceus369 (€5.56 in chips) 
Seat 5: Crock361 (€2.21 in chips) 
Seat 6: TheMule1454 (€0.98 in chips) 
gigiriver170: posts small blind €0.01
miridersa: posts big blind €0.02
*** HOLE CARDS ***
Dealt to caduceus369 [Kh 9h]
caduceus369: raises €0.04 to €0.06
Crock361: folds 
TheMule1454: folds 
CarlaBBruni: calls €0.06
gigiriver170: calls €0.05
miridersa: folds 
*** FLOP *** [5s Jc 3s]
gigiriver170: checks 
caduceus369: checks 
CarlaBBruni: checks 
*** TURN *** [5s Jc 3s] [Ad]
gigiriver170: bets €0.06
caduceus369: folds 
CarlaBBruni: calls €0.06
*** RIVER *** [5s Jc 3s Ad] [7s]
gigiriver170: checks 
CarlaBBruni: checks 
*** SHOW DOWN ***
gigiriver170: shows [8h 8d] (a pair of Eights)
CarlaBBruni: shows [Ac 9c] (a pair of Aces)
CarlaBBruni collected €0.31 from pot
*** SUMMARY ***
Total pot €0.32 | Rake €0.01 
Board [5s Jc 3s Ad 7s]
Seat 1: CarlaBBruni (button) showed [Ac 9c] and won (€0.31) with a pair of Aces
Seat 2: gigiriver170 (small blind) showed [8h 8d] and lost with a pair of Eights
Seat 3: miridersa (big blind) folded before Flop
Seat 4: caduceus369 folded on the Turn
Seat 5: Crock361 folded before Flop (didn't bet)
Seat 6: TheMule1454 folded before Flop (didn't bet)



PokerStars Zoom Hand #258128964272:  Hold'em No Limit (€0.01/€0.02) [ADM ID: M62C63044C87BABT] - 2025/10/15 0:49:21 CET [2025/10/14 18:49:21 ET]
Table 'Sirio' 6-max Seat #1 is the button
Seat 1: TheMule1454 (€0.98 in chips) 
Seat 2: McSup (€3.92 in chips) 
Seat 3: Begimon (€11.93 in chips) 
Seat 4: caduceus369 (€5.56 in chips) 
Seat 5: Warterror90 (€3.82 in chips) 
Seat 6: CarlaBBruni (€1.87 in chips) 
McSup: posts small blind €0.01
Begimon: posts big blind €0.02
*** HOLE CARDS ***
Dealt to caduceus369 [3d Qs]
caduceus369: folds 
Warterror90: raises €0.04 to €0.06
CarlaBBruni: folds 
TheMule1454: folds 
McSup: calls €0.05
Begimon is disconnected 
Begimon has timed out while disconnected
Begimon: folds 
*** FLOP *** [7h 9d 4d]
McSup: bets €0.07
Warterror90: calls €0.07
*** TURN *** [7h 9d 4d] [6c]
McSup: checks 
Warterror90: bets €0.08
McSup: folds 
Uncalled bet (€0.08) returned to Warterror90
Warterror90 collected €0.27 from pot
Warterror90: doesn't show hand 
*** SUMMARY ***
Total pot €0.28 | Rake €0.01 
Board [7h 9d 4d 6c]
Seat 1: TheMule1454 (button) folded before Flop (didn't bet)
Seat 2: McSup (small blind) folded on the Turn
Seat 3: Begimon (big blind) folded before Flop
Seat 4: caduceus369 folded before Flop (didn't bet)
Seat 5: Warterror90 collected (€0.27)
Seat 6: CarlaBBruni folded before Flop (didn't bet)



PokerStars Zoom Hand #258128972580:  Hold'em No Limit (€0.01/€0.02) [ADM ID: M62C63044C87BABT] - 2025/10/15 0:50:05 CET [2025/10/14 18:50:05 ET]
Table 'Sirio' 6-max Seat #1 is the button
Seat 1: mashallahh (€2.78 in chips) 
Seat 2: Agnese84 (€1.42 in chips) 
Seat 3: caduceus369 (€5.50 in chips) 
Seat 4: Warterror90 (€2.60 in chips) 
Seat 5: CarlaBBruni (€1.84 in chips) 
Seat 6: Trezvenik93 (€2 in chips) 
Agnese84: posts small blind €0.01
caduceus369: posts big blind €0.02
*** HOLE CARDS ***
Dealt to caduceus369 [9d 8h]
Warterror90: folds 
CarlaBBruni: raises €0.02 to €0.04
Trezvenik93: folds 
mashallahh: folds 
Agnese84: folds 
caduceus369: calls €0.02
*** FLOP *** [Th 7c 2h]
caduceus369: bets €0.04
CarlaBBruni: calls €0.04
*** TURN *** [Th 7c 2h] [7h]
caduceus369: checks 
CarlaBBruni: checks 
*** RIVER *** [Th 7c 2h 7h] [7s]
caduceus369: bets €0.06
CarlaBBruni: raises €0.16 to €0.22
caduceus369: folds 
Uncalled bet (€0.16) returned to CarlaBBruni
CarlaBBruni collected €0.28 from pot
CarlaBBruni: doesn't show hand 
*** SUMMARY ***
Total pot €0.29 | Rake €0.01 
Board [Th 7c 2h 7h 7s]
Seat 1: mashallahh (button) folded before Flop (didn't bet)
Seat 2: Agnese84 (small blind) folded before Flop
Seat 3: caduceus369 (big blind) folded on the River
Seat 4: Warterror90 folded before Flop (didn't bet)
Seat 5: CarlaBBruni collected (€0.28)
Seat 6: Trezvenik93 folded before Flop (didn't bet)



PokerStars Zoom Hand #258128983867:  Hold'em No Limit (€0.01/€0.02) [ADM ID: M62C63044C87BABT] - 2025/10/15 0:51:06 CET [2025/10/14 18:51:06 ET]
Table 'Sirio' 6-max Seat #1 is the button
Seat 1: SebaRapy14 (€3.22 in chips) 
Seat 2: caduceus369 (€5.36 in chips) 
Seat 3: mashallahh (€5.47 in chips) 
Seat 4: miridersa (€0.70 in chips) 
Seat 5: father2008 (€2.04 in chips) 
Seat 6: uziu47 (€1.12 in chips) 
caduceus369: posts small blind €0.01
mashallahh: posts big blind €0.02
*** HOLE CARDS ***
Dealt to caduceus369 [Jd 7d]
miridersa: folds 
father2008: folds 
uziu47: folds 
SebaRapy14: folds 
caduceus369: folds 
Uncalled bet (€0.01) returned to mashallahh
mashallahh collected €0.02 from pot
mashallahh: doesn't show hand 
*** SUMMARY ***
Total pot €0.02 | Rake €0 
Seat 1: SebaRapy14 (button) folded before Flop (didn't bet)
Seat 2: caduceus369 (small blind) folded before Flop
Seat 3: mashallahh (big blind) collected (€0.02)
Seat 4: miridersa folded before Flop (didn't bet)
Seat 5: father2008 folded before Flop (didn't bet)
Seat 6: uziu47 folded before Flop (didn't bet)



PokerStars Zoom Hand #258128987213:  Hold'em No Limit (€0.01/€0.02) [ADM ID: M62C63044C87BABT] - 2025/10/15 0:51:24 CET [2025/10/14 18:51:24 ET]
Table 'Sirio' 6-max Seat #1 is the button
Seat 1: Crock361 (€2.25 in chips) 
Seat 2: This Heat (€1.21 in chips) 
Seat 3: CarlaBBruni (€1.97 in chips) 
Seat 4: Rrrr322 (€1.22 in chips) 
Seat 5: TheMule1454 (€3.19 in chips) 
Seat 6: caduceus369 (€5.35 in chips) 
This Heat: posts small blind €0.01
CarlaBBruni: posts big blind €0.02
*** HOLE CARDS ***
Dealt to caduceus369 [5d Kc]
Rrrr322: calls €0.02
TheMule1454: folds 
caduceus369: folds 
Crock361: folds 
This Heat: folds 
CarlaBBruni: checks 
*** FLOP *** [As 3h Jh]
CarlaBBruni: checks 
Rrrr322: checks 
*** TURN *** [As 3h Jh] [6h]
CarlaBBruni: checks 
Rrrr322: checks 
*** RIVER *** [As 3h Jh 6h] [Ac]
CarlaBBruni: checks 
Rrrr322: bets €0.08
CarlaBBruni: folds 
Uncalled bet (€0.08) returned to Rrrr322
Rrrr322 collected €0.05 from pot
Rrrr322: doesn't show hand 
*** SUMMARY ***
Total pot €0.05 | Rake €0 
Board [As 3h Jh 6h Ac]
Seat 1: Crock361 (button) folded before Flop (didn't bet)
Seat 2: This Heat (small blind) folded before Flop
Seat 3: CarlaBBruni (big blind) folded on the River
Seat 4: Rrrr322 collected (€0.05)
Seat 5: TheMule1454 folded before Flop (didn't bet)
Seat 6: caduceus369 folded before Flop (didn't bet)



PokerStars Zoom Hand #258128994794:  Hold'em No Limit (€0.01/€0.02) [ADM ID: M62C63044C87BABT] - 2025/10/15 0:52:06 CET [2025/10/14 18:52:06 ET]
Table 'Sirio' 6-max Seat #1 is the button
Seat 1: 2PaperelaSgubio (€2.15 in chips) 
Seat 2: CarlaBBruni (€1.95 in chips) 
Seat 3: McSup (€3.89 in chips) 
Seat 4: Catania838 (€3.87 in chips) 
Seat 5: caduceus369 (€5.35 in chips) 
Seat 6: This Heat (€1.17 in chips) 
CarlaBBruni: posts small blind €0.01
McSup: posts big blind €0.02
*** HOLE CARDS ***
Dealt to caduceus369 [9c 6s]
Catania838: folds 
caduceus369: folds 
This Heat: raises €0.04 to €0.06
2PaperelaSgubio: folds 
CarlaBBruni: folds 
McSup: folds 
Uncalled bet (€0.04) returned to This Heat
This Heat collected €0.05 from pot
This Heat: doesn't show hand 
*** SUMMARY ***
Total pot €0.05 | Rake €0 
Seat 1: 2PaperelaSgubio (button) folded before Flop (didn't bet)
Seat 2: CarlaBBruni (small blind) folded before Flop
Seat 3: McSup (big blind) folded before Flop
Seat 4: Catania838 folded before Flop (didn't bet)
Seat 5: caduceus369 folded before Flop (didn't bet)
Seat 6: This Heat collected (€0.05)



PokerStars Zoom Hand #258128991905:  Hold'em No Limit (€0.01/€0.02) [ADM ID: M62C63044C87BABT] - 2025/10/15 0:51:50 CET [2025/10/14 18:51:50 ET]
Table 'Sirio' 6-max Seat #1 is the button
Seat 1: CarlaBBruni (€4.54 in chips) 
Seat 2: QUEEN-KING-QQKK (€1.83 in chips) 
Seat 3: father2008 (€2.03 in chips) 
Seat 4: Poetto65 (€0.94 in chips) 
Seat 5: This Heat (€1.18 in chips) 
Seat 6: caduceus369 (€5.35 in chips) 
QUEEN-KING-QQKK: posts small blind €0.01
father2008: posts big blind €0.02
*** HOLE CARDS ***
Dealt to caduceus369 [6d Qd]
Poetto65: folds 
This Heat: folds 
caduceus369: folds 
CarlaBBruni: raises €0.03 to €0.05
QUEEN-KING-QQKK: raises €1.78 to €1.83 and is all-in
father2008: folds 
CarlaBBruni: folds 
Uncalled bet (€1.78) returned to QUEEN-KING-QQKK
QUEEN-KING-QQKK collected €0.12 from pot
QUEEN-KING-QQKK: doesn't show hand 
*** SUMMARY ***
Total pot €0.12 | Rake €0 
Seat 1: CarlaBBruni (button) folded before Flop
Seat 2: QUEEN-KING-QQKK (small blind) collected (€0.12)
Seat 3: father2008 (big blind) folded before Flop
Seat 4: Poetto65 folded before Flop (didn't bet)
Seat 5: This Heat folded before Flop (didn't bet)
Seat 6: caduceus369 folded before Flop (didn't bet)



PokerStars Zoom Hand #258128988545:  Hold'em No Limit (€0.01/€0.02) [ADM ID: M62C63044C87BABT] - 2025/10/15 0:51:31 CET [2025/10/14 18:51:31 ET]
Table 'Sirio' 6-max Seat #1 is the button
Seat 1: caduceus369 (€5.35 in chips) 
Seat 2: miridersa (€0.71 in chips) 
Seat 3: Alifatti (€1.07 in chips) 
Seat 4: CarlaBBruni (€4.55 in chips) 
Seat 5: mashallahh (€8.55 in chips) 
Seat 6: ADRIAN0_MEIS (€5.14 in chips) 
miridersa: posts small blind €0.01
Alifatti: posts big blind €0.02
*** HOLE CARDS ***
Dealt to caduceus369 [9d Kh]
CarlaBBruni: folds 
mashallahh: raises €0.04 to €0.06
ADRIAN0_MEIS: calls €0.06
caduceus369: folds 
miridersa: folds 
Alifatti: calls €0.04
*** FLOP *** [8d 2s Qd]
Alifatti: checks 
mashallahh: checks 
ADRIAN0_MEIS: checks 
*** TURN *** [8d 2s Qd] [4s]
Alifatti: checks 
mashallahh: bets €0.14
ADRIAN0_MEIS: calls €0.14
Alifatti: folds 
*** RIVER *** [8d 2s Qd 4s] [Ts]
mashallahh: checks 
ADRIAN0_MEIS: checks 
*** SHOW DOWN ***
mashallahh: shows [Tc Ad] (a pair of Tens)
ADRIAN0_MEIS: mucks hand 
mashallahh collected €0.45 from pot
*** SUMMARY ***
Total pot €0.47 | Rake €0.02 
Board [8d 2s Qd 4s Ts]
Seat 1: caduceus369 (button) folded before Flop (didn't bet)
Seat 2: miridersa (small blind) folded before Flop
Seat 3: Alifatti (big blind) folded on the Turn
Seat 4: CarlaBBruni folded before Flop (didn't bet)
Seat 5: mashallahh showed [Tc Ad] and won (€0.45) with a pair of Tens
Seat 6: ADRIAN0_MEIS mucked [6d 7d]



PokerStars Zoom Hand #258128995551:  Hold'em No Limit (€0.01/€0.02) [ADM ID: M62C63044C87BABT] - 2025/10/15 0:52:10 CET [2025/10/14 18:52:10 ET]
Table 'Sirio' 6-max Seat #1 is the button
Seat 1: Warterror90 (€3 in chips) 
Seat 2: Poetto65 (€0.92 in chips) 
Seat 3: caduceus369 (€5.35 in chips) 
Seat 4: miridersa (€0.70 in chips) 
Seat 5: Crock361 (€2.05 in chips) 
Seat 6: CarlaBBruni (€1.94 in chips) 
Poetto65: posts small blind €0.01
caduceus369: posts big blind €0.02
*** HOLE CARDS ***
Dealt to caduceus369 [6s Qc]
miridersa: folds 
Crock361: folds 
CarlaBBruni: folds 
Warterror90: folds 
Poetto65: calls €0.01
caduceus369: checks 
*** FLOP *** [5h 7s Td]
Poetto65: checks 
caduceus369: checks 
*** TURN *** [5h 7s Td] [6h]
Poetto65: checks 
caduceus369: checks 
*** RIVER *** [5h 7s Td 6h] [2s]
Poetto65: checks 
caduceus369: checks 
*** SHOW DOWN ***
Poetto65: shows [Qd 9h] (high card Queen)
caduceus369: shows [6s Qc] (a pair of Sixes)
caduceus369 collected €0.04 from pot
*** SUMMARY ***
Total pot €0.04 | Rake €0 
Board [5h 7s Td 6h 2s]
Seat 1: Warterror90 (button) folded before Flop (didn't bet)
Seat 2: Poetto65 (small blind) showed [Qd 9h] and lost with high card Queen
Seat 3: caduceus369 (big blind) showed [6s Qc] and won (€0.04) with a pair of Sixes
Seat 4: miridersa folded before Flop (didn't bet)
Seat 5: Crock361 folded before Flop (didn't bet)
Seat 6: CarlaBBruni folded before Flop (didn't bet)



PokerStars Zoom Hand #258129007528:  Hold'em No Limit (€0.01/€0.02) [ADM ID: M62C63044C87BABT] - 2025/10/15 0:53:15 CET [2025/10/14 18:53:15 ET]
Table 'Sirio' 6-max Seat #1 is the button
Seat 1: Warterror90 (€3.03 in chips) 
Seat 2: caduceus369 (€5.37 in chips) 
Seat 3: Crock361 (€2.62 in chips) 
Seat 4: mashallahh (€2.78 in chips) 
Seat 5: franck19621962 (€0.61 in chips) 
Seat 6: Poetto65 (€0.90 in chips) 
caduceus369: posts small blind €0.01
Crock361: posts big blind €0.02
*** HOLE CARDS ***
Dealt to caduceus369 [Qs Js]
mashallahh: folds 
franck19621962: folds 
Poetto65: folds 
Warterror90: folds 
caduceus369: raises €0.04 to €0.06
Crock361: folds 
Uncalled bet (€0.04) returned to caduceus369
caduceus369 collected €0.04 from pot
caduceus369: doesn't show hand 
*** SUMMARY ***
Total pot €0.04 | Rake €0 
Seat 1: Warterror90 (button) folded before Flop (didn't bet)
Seat 2: caduceus369 (small blind) collected (€0.04)
Seat 3: Crock361 (big blind) folded before Flop
Seat 4: mashallahh folded before Flop (didn't bet)
Seat 5: franck19621962 folded before Flop (didn't bet)
Seat 6: Poetto65 folded before Flop (didn't bet)



PokerStars Zoom Hand #258129016720:  Hold'em No Limit (€0.01/€0.02) [ADM ID: M62C63044C87BABT] - 2025/10/15 0:54:06 CET [2025/10/14 18:54:06 ET]
Table 'Sirio' 6-max Seat #1 is the button
Seat 1: caduceus369 (€5.39 in chips) 
Seat 2: Crock361 (€2.61 in chips) 
Seat 3: Warterror90 (€4.54 in chips) 
Seat 4: father2008 (€2 in chips) 
Seat 5: gigiriver170 (€0.75 in chips) 
Seat 6: EasyToRule (€2.05 in chips) 
Crock361: posts small blind €0.01
Warterror90: posts big blind €0.02
*** HOLE CARDS ***
Dealt to caduceus369 [Ks 7s]
father2008: folds 
gigiriver170 is disconnected 
gigiriver170: folds 
EasyToRule: folds 
Crock361 is disconnected 
caduceus369: raises €0.04 to €0.06
Crock361 has timed out while disconnected
Crock361: folds 
Warterror90: folds 
Uncalled bet (€0.04) returned to caduceus369
caduceus369 collected €0.05 from pot
caduceus369: doesn't show hand 
*** SUMMARY ***
Total pot €0.05 | Rake €0 
Seat 1: caduceus369 (button) collected (€0.05)
Seat 2: Crock361 (small blind) folded before Flop
Seat 3: Warterror90 (big blind) folded before Flop
Seat 4: father2008 folded before Flop (didn't bet)
Seat 5: gigiriver170 folded before Flop (didn't bet)
Seat 6: EasyToRule folded before Flop (didn't bet)



PokerStars Zoom Hand #258129027634:  Hold'em No Limit (€0.01/€0.02) [ADM ID: M62C63044C87BABT] - 2025/10/15 0:55:06 CET [2025/10/14 18:55:06 ET]
Table 'Sirio' 6-max Seat #1 is the button
Seat 1: McSup (€1.77 in chips) 
Seat 2: Begimon (€11.60 in chips) 
Seat 3: CarlaBBruni (€1.86 in chips) 
Seat 4: EasyToRule (€2.13 in chips) 
Seat 5: mashallahh (€8.77 in chips) 
Seat 6: caduceus369 (€5.42 in chips) 
Begimon: posts small blind €0.01
CarlaBBruni: posts big blind €0.02
*** HOLE CARDS ***
Dealt to caduceus369 [Js Qd]
EasyToRule: folds 
mashallahh: folds 
caduceus369: raises €0.04 to €0.06
McSup: calls €0.06
Begimon: folds 
CarlaBBruni: folds 
*** FLOP *** [2d 6c 6h]
caduceus369: checks 
McSup: checks 
*** TURN *** [2d 6c 6h] [4h]
caduceus369: checks 
McSup: checks 
*** RIVER *** [2d 6c 6h 4h] [8c]
caduceus369: checks 
McSup: bets €0.04
caduceus369: folds 
Uncalled bet (€0.04) returned to McSup
McSup collected €0.15 from pot
McSup: doesn't show hand 
*** SUMMARY ***
Total pot €0.15 | Rake €0 
Board [2d 6c 6h 4h 8c]
Seat 1: McSup (button) collected (€0.15)
Seat 2: Begimon (small blind) folded before Flop
Seat 3: CarlaBBruni (big blind) folded before Flop
Seat 4: EasyToRule folded before Flop (didn't bet)
Seat 5: mashallahh folded before Flop (didn't bet)
Seat 6: caduceus369 folded on the River



PokerStars Zoom Hand #258129036869:  Hold'em No Limit (€0.01/€0.02) [ADM ID: M62C63044C87BABT] - 2025/10/15 0:56:07 CET [2025/10/14 18:56:07 ET]
Table 'Sirio' 6-max Seat #1 is the button
Seat 1: mashallahh (€8.83 in chips) 
Seat 2: caduceus369 (€5.36 in chips) 
Seat 3: CarlaBBruni (€1.82 in chips) 
Seat 4: Begimon (€11.36 in chips) 
Seat 5: QUEEN-KING-QQKK (€3.24 in chips) 
Seat 6: Warterror90 (€4.26 in chips) 
caduceus369: posts small blind €0.01
CarlaBBruni: posts big blind €0.02
*** HOLE CARDS ***
Dealt to caduceus369 [Ts 7c]
Begimon: folds 
QUEEN-KING-QQKK: folds 
Warterror90: folds 
mashallahh: folds 
caduceus369: folds 
Uncalled bet (€0.01) returned to CarlaBBruni
CarlaBBruni collected €0.02 from pot
CarlaBBruni: doesn't show hand 
*** SUMMARY ***
Total pot €0.02 | Rake €0 
Seat 1: mashallahh (button) folded before Flop (didn't bet)
Seat 2: caduceus369 (small blind) folded before Flop
Seat 3: CarlaBBruni (big blind) collected (€0.02)
Seat 4: Begimon folded before Flop (didn't bet)
Seat 5: QUEEN-KING-QQKK folded before Flop (didn't bet)
Seat 6: Warterror90 folded before Flop (didn't bet)



PokerStars Zoom Hand #258129036402:  Hold'em No Limit (€0.01/€0.02) [ADM ID: M62C63044C87BABT] - 2025/10/15 0:56:04 CET [2025/10/14 18:56:04 ET]
Table 'Sirio' 6-max Seat #1 is the button
Seat 1: ADRIAN0_MEIS (€5.41 in chips) 
Seat 2: EasyToRule (€2.06 in chips) 
Seat 3: CarlaBBruni (€4.34 in chips) 
Seat 4: caduceus369 (€5.36 in chips) 
Seat 5: Poetto65 (€1.01 in chips) 
Seat 6: McSup (€1.86 in chips) 
EasyToRule: posts small blind €0.01
CarlaBBruni: posts big blind €0.02
*** HOLE CARDS ***
Dealt to caduceus369 [8c 6s]
caduceus369: folds 
Poetto65: folds 
McSup: folds 
ADRIAN0_MEIS: raises €0.04 to €0.06
EasyToRule: folds 
CarlaBBruni: folds 
Uncalled bet (€0.04) returned to ADRIAN0_MEIS
ADRIAN0_MEIS collected €0.05 from pot
ADRIAN0_MEIS: doesn't show hand 
*** SUMMARY ***
Total pot €0.05 | Rake €0 
Seat 1: ADRIAN0_MEIS (button) collected (€0.05)
Seat 2: EasyToRule (small blind) folded before Flop
Seat 3: CarlaBBruni (big blind) folded before Flop
Seat 4: caduceus369 folded before Flop (didn't bet)
Seat 5: Poetto65 folded before Flop (didn't bet)
Seat 6: McSup folded before Flop (didn't bet)



PokerStars Zoom Hand #258129036006:  Hold'em No Limit (€0.01/€0.02) [ADM ID: M62C63044C87BABT] - 2025/10/15 0:56:01 CET [2025/10/14 18:56:01 ET]
Table 'Sirio' 6-max Seat #1 is the button
Seat 1: Warterror90 (€4.26 in chips) 
Seat 2: mashallahh (€5.98 in chips) 
Seat 3: miridersa (€0.73 in chips) 
Seat 4: CIKO71131 (€0.71 in chips) 
Seat 5: caduceus369 (€5.36 in chips) 
Seat 6: QUEEN-KING-QQKK (€3.24 in chips) 
mashallahh: posts small blind €0.01
miridersa: posts big blind €0.02
*** HOLE CARDS ***
Dealt to caduceus369 [5h Ts]
CIKO71131: folds 
caduceus369: folds 
QUEEN-KING-QQKK: folds 
Warterror90: folds 
mashallahh: calls €0.01
miridersa: checks 
*** FLOP *** [Kh 2s Jh]
mashallahh: checks 
miridersa: checks 
*** TURN *** [Kh 2s Jh] [7s]
mashallahh: checks 
miridersa: checks 
*** RIVER *** [Kh 2s Jh 7s] [4d]
mashallahh: checks 
miridersa: checks 
*** SHOW DOWN ***
mashallahh: shows [2d 3d] (a pair of Deuces)
miridersa: mucks hand 
mashallahh collected €0.04 from pot
*** SUMMARY ***
Total pot €0.04 | Rake €0 
Board [Kh 2s Jh 7s 4d]
Seat 1: Warterror90 (button) folded before Flop (didn't bet)
Seat 2: mashallahh (small blind) showed [2d 3d] and won (€0.04) with a pair of Deuces
Seat 3: miridersa (big blind) mucked [Ac 9d]
Seat 4: CIKO71131 folded before Flop (didn't bet)
Seat 5: caduceus369 folded before Flop (didn't bet)
Seat 6: QUEEN-KING-QQKK folded before Flop (didn't bet)



PokerStars Zoom Hand #258129037429:  Hold'em No Limit (€0.01/€0.02) [ADM ID: M62C63044C87BABT] - 2025/10/15 0:56:11 CET [2025/10/14 18:56:11 ET]
Table 'Sirio' 6-max Seat #1 is the button
Seat 1: father2008 (€2.37 in chips) 
Seat 2: Poetto65 (€1.01 in chips) 
Seat 3: caduceus369 (€5.35 in chips) 
Seat 4: QUEEN-KING-QQKK (€3.24 in chips) 
Seat 5: Begimon (€11.36 in chips) 
Seat 6: mashallahh (€8.83 in chips) 
Poetto65: posts small blind €0.01
caduceus369: posts big blind €0.02
*** HOLE CARDS ***
Dealt to caduceus369 [3c 8s]
QUEEN-KING-QQKK: folds 
Begimon: calls €0.02
mashallahh: folds 
father2008: folds 
Poetto65: folds 
caduceus369: checks 
*** FLOP *** [4d Td 8c]
caduceus369: checks 
Begimon: checks 
*** TURN *** [4d Td 8c] [Qd]
caduceus369: checks 
Begimon: checks 
*** RIVER *** [4d Td 8c Qd] [3d]
caduceus369: bets €0.06
Begimon: raises €0.06 to €0.12
caduceus369: calls €0.06
*** SHOW DOWN ***
Begimon: shows [As Kd] (a flush, King high)
caduceus369: mucks hand 
Begimon collected €0.28 from pot
*** SUMMARY ***
Total pot €0.29 | Rake €0.01 
Board [4d Td 8c Qd 3d]
Seat 1: father2008 (button) folded before Flop (didn't bet)
Seat 2: Poetto65 (small blind) folded before Flop
Seat 3: caduceus369 (big blind) mucked [3c 8s]
Seat 4: QUEEN-KING-QQKK folded before Flop (didn't bet)
Seat 5: Begimon showed [As Kd] and won (€0.28) with a flush, King high
Seat 6: mashallahh folded before Flop (didn't bet)



PokerStars Zoom Hand #258129043543:  Hold'em No Limit (€0.01/€0.02) [ADM ID: M62C63044C87BABT] - 2025/10/15 0:56:53 CET [2025/10/14 18:56:53 ET]
Table 'Sirio' 6-max Seat #1 is the button
Seat 1: caduceus369 (€5.21 in chips) 
Seat 2: CarlaBBruni (€1.78 in chips) 
Seat 3: Begimon (€11.50 in chips) 
Seat 4: Temait77728 (€3.84 in chips) 
Seat 5: meteco79 (€1.12 in chips) 
Seat 6: father2008 (€2 in chips) 
CarlaBBruni: posts small blind €0.01
Begimon: posts big blind €0.02
*** HOLE CARDS ***
Dealt to caduceus369 [3h Ks]
Temait77728: folds 
meteco79: calls €0.02
father2008: raises €0.07 to €0.09
caduceus369: folds 
CarlaBBruni: folds 
Begimon: calls €0.07
meteco79: folds 
*** FLOP *** [7s Js 4s]
Begimon: checks 
father2008: checks 
*** TURN *** [7s Js 4s] [Qh]
Begimon: checks 
father2008: checks 
*** RIVER *** [7s Js 4s Qh] [9d]
Begimon: bets €0.06
father2008: calls €0.06
*** SHOW DOWN ***
Begimon: shows [Qs Td] (a pair of Queens)
father2008: mucks hand 
Begimon collected €0.32 from pot
*** SUMMARY ***
Total pot €0.33 | Rake €0.01 
Board [7s Js 4s Qh 9d]
Seat 1: caduceus369 (button) folded before Flop (didn't bet)
Seat 2: CarlaBBruni (small blind) folded before Flop
Seat 3: Begimon (big blind) showed [Qs Td] and won (€0.32) with a pair of Queens
Seat 4: Temait77728 folded before Flop (didn't bet)
Seat 5: meteco79 folded before Flop
Seat 6: father2008 mucked [Ts Th]



PokerStars Zoom Hand #258129044816:  Hold'em No Limit (€0.01/€0.02) [ADM ID: M62C63044C87BABT] - 2025/10/15 0:57:02 CET [2025/10/14 18:57:02 ET]
Table 'Sirio' 6-max Seat #1 is the button
Seat 1: miridersa (€0.74 in chips) 
Seat 2: McSup (€3.74 in chips) 
Seat 3: franck19621962 (€0.25 in chips) 
Seat 4: meteco79 (€1.10 in chips) 
Seat 5: il_jack$$$58 (€2.37 in chips) 
Seat 6: caduceus369 (€5.21 in chips) 
McSup: posts small blind €0.01
franck19621962: posts big blind €0.02
*** HOLE CARDS ***
Dealt to caduceus369 [2d Kc]
meteco79: calls €0.02
il_jack$$$58: folds 
caduceus369: folds 
miridersa: calls €0.02
McSup: calls €0.01
franck19621962: checks 
*** FLOP *** [6c 4h 2s]
McSup: checks 
franck19621962: checks 
meteco79: checks 
miridersa: checks 
*** TURN *** [6c 4h 2s] [Ks]
McSup: checks 
franck19621962: checks 
meteco79: checks 
miridersa: checks 
*** RIVER *** [6c 4h 2s Ks] [9d]
McSup: checks 
franck19621962: checks 
meteco79: checks 
miridersa: checks 
*** SHOW DOWN ***
McSup: shows [Ac 7h] (high card Ace)
franck19621962: mucks hand 
meteco79: shows [7d Ad] (high card Ace)
miridersa: mucks hand 
McSup collected €0.04 from pot
meteco79 collected €0.04 from pot
*** SUMMARY ***
Total pot €0.08 | Rake €0 
Board [6c 4h 2s Ks 9d]
Seat 1: miridersa (button) mucked [Jd Tc]
Seat 2: McSup (small blind) showed [Ac 7h] and won (€0.04) with high card Ace
Seat 3: franck19621962 (big blind) mucked [7c 3c]
Seat 4: meteco79 showed [7d Ad] and won (€0.04) with high card Ace
Seat 5: il_jack$$$58 folded before Flop (didn't bet)
Seat 6: caduceus369 folded before Flop (didn't bet)



PokerStars Zoom Hand #258129045781:  Hold'em No Limit (€0.01/€0.02) [ADM ID: M62C63044C87BABT] - 2025/10/15 0:57:09 CET [2025/10/14 18:57:09 ET]
Table 'Sirio' 6-max Seat #1 is the button
Seat 1: This Heat (€2.65 in chips) 
Seat 2: il_jack$$$58 (€2.37 in chips) 
Seat 3: CarlaBBruni (€4.22 in chips) 
Seat 4: EasyToRule (€2.08 in chips) 
Seat 5: caduceus369 (€5.21 in chips) 
Seat 6: TheMule1454 (€2.86 in chips) 
il_jack$$$58: posts small blind €0.01
CarlaBBruni: posts big blind €0.02
*** HOLE CARDS ***
Dealt to caduceus369 [Kd Ks]
EasyToRule: folds 
caduceus369: raises €0.04 to €0.06
TheMule1454: raises €0.15 to €0.21
This Heat: calls €0.21
il_jack$$$58: folds 
CarlaBBruni: folds 
caduceus369: raises €0.49 to €0.70
TheMule1454: calls €0.49
This Heat: calls €0.49
*** FLOP *** [Td 3s Qs]
caduceus369: bets €1.01
TheMule1454: folds 
This Heat: raises €0.94 to €1.95 and is all-in
caduceus369: calls €0.94
*** TURN *** [Td 3s Qs] [6c]
*** RIVER *** [Td 3s Qs 6c] [9d]
*** SHOW DOWN ***
caduceus369: shows [Kd Ks] (a pair of Kings)
This Heat: shows [6s 8s] (a pair of Sixes)
caduceus369 collected €5.70 from pot
*** SUMMARY ***
Total pot €6.03 | Rake €0.33 
Board [Td 3s Qs 6c 9d]
Seat 1: This Heat (button) showed [6s 8s] and lost with a pair of Sixes
Seat 2: il_jack$$$58 (small blind) folded before Flop
Seat 3: CarlaBBruni (big blind) folded before Flop
Seat 4: EasyToRule folded before Flop (didn't bet)
Seat 5: caduceus369 showed [Kd Ks] and won (€5.70) with a pair of Kings
Seat 6: TheMule1454 folded on the Flop



PokerStars Zoom Hand #258129053025:  Hold'em No Limit (€0.01/€0.02) [ADM ID: M62C63044C87BABT] - 2025/10/15 0:57:59 CET [2025/10/14 18:57:59 ET]
Table 'Sirio' 6-max Seat #1 is the button
Seat 1: mashallahh (€8.30 in chips) 
Seat 2: Warterror90 (€5.02 in chips) 
Seat 3: miridersa (€0.72 in chips) 
Seat 4: caduceus369 (€8.26 in chips) 
Seat 5: Trezvenik93 (€2.49 in chips) 
Seat 6: QUEEN-KING-QQKK (€3.28 in chips) 
Warterror90: posts small blind €0.01
miridersa: posts big blind €0.02
*** HOLE CARDS ***
Dealt to caduceus369 [Qc 7d]
caduceus369: folds 
Trezvenik93: folds 
QUEEN-KING-QQKK: folds 
mashallahh: folds 
Warterror90: folds 
Uncalled bet (€0.01) returned to miridersa
miridersa collected €0.02 from pot
miridersa: doesn't show hand 
*** SUMMARY ***
Total pot €0.02 | Rake €0 
Seat 1: mashallahh (button) folded before Flop (didn't bet)
Seat 2: Warterror90 (small blind) folded before Flop
Seat 3: miridersa (big blind) collected (€0.02)
Seat 4: caduceus369 folded before Flop (didn't bet)
Seat 5: Trezvenik93 folded before Flop (didn't bet)
Seat 6: QUEEN-KING-QQKK folded before Flop (didn't bet)



PokerStars Zoom Hand #258129053873:  Hold'em No Limit (€0.01/€0.02) [ADM ID: M62C63044C87BABT] - 2025/10/15 0:58:05 CET [2025/10/14 18:58:05 ET]
Table 'Sirio' 6-max Seat #1 is the button
Seat 1: TheMule1454 (€2.15 in chips) 
Seat 2: Temait77728 (€3.19 in chips) 
Seat 3: QUEEN-KING-QQKK (€3.28 in chips) 
Seat 4: Warterror90 (€7.36 in chips) 
Seat 5: caduceus369 (€8.26 in chips) 
Seat 6: il_jack$$$58 (€2.42 in chips) 
Temait77728: posts small blind €0.01
QUEEN-KING-QQKK: posts big blind €0.02
*** HOLE CARDS ***
Dealt to caduceus369 [4c 5s]
Warterror90: raises €0.04 to €0.06
caduceus369: folds 
il_jack$$$58: folds 
TheMule1454: folds 
Temait77728: folds 
QUEEN-KING-QQKK: folds 
Uncalled bet (€0.04) returned to Warterror90
Warterror90 collected €0.05 from pot
Warterror90: doesn't show hand 
*** SUMMARY ***
Total pot €0.05 | Rake €0 
Seat 1: TheMule1454 (button) folded before Flop (didn't bet)
Seat 2: Temait77728 (small blind) folded before Flop
Seat 3: QUEEN-KING-QQKK (big blind) folded before Flop
Seat 4: Warterror90 collected (€0.05)
Seat 5: caduceus369 folded before Flop (didn't bet)
Seat 6: il_jack$$$58 folded before Flop (didn't bet)



PokerStars Zoom Hand #258129056475:  Hold'em No Limit (€0.01/€0.02) [ADM ID: M62C63044C87BABT] - 2025/10/15 0:58:23 CET [2025/10/14 18:58:23 ET]
Table 'Sirio' 6-max Seat #1 is the button
Seat 1: franck19621962 (€0.21 in chips) 
Seat 2: McSup (€3.76 in chips) 
Seat 3: uziu47 (€0.90 in chips) 
Seat 4: caduceus369 (€8.25 in chips) 
Seat 5: Warterror90 (€5.01 in chips) 
Seat 6: CarlaBBruni (€2.18 in chips) 
McSup: posts small blind €0.01
uziu47: posts big blind €0.02
*** HOLE CARDS ***
Dealt to caduceus369 [2d 8c]
caduceus369: folds 
Warterror90: folds 
CarlaBBruni: folds 
franck19621962: folds 
McSup: folds 
Uncalled bet (€0.01) returned to uziu47
uziu47 collected €0.02 from pot
uziu47: doesn't show hand 
*** SUMMARY ***
Total pot €0.02 | Rake €0 
Seat 1: franck19621962 (button) folded before Flop (didn't bet)
Seat 2: McSup (small blind) folded before Flop
Seat 3: uziu47 (big blind) collected (€0.02)
Seat 4: caduceus369 folded before Flop (didn't bet)
Seat 5: Warterror90 folded before Flop (didn't bet)
Seat 6: CarlaBBruni folded before Flop (didn't bet)



PokerStars Zoom Hand #258129054563:  Hold'em No Limit (€0.01/€0.02) [ADM ID: M62C63044C87BABT] - 2025/10/15 0:58:10 CET [2025/10/14 18:58:10 ET]
Table 'Sirio' 6-max Seat #1 is the button
Seat 1: uziu47 (€0.90 in chips) 
Seat 2: caduceus369 (€8.26 in chips) 
Seat 3: il_jack$$$58 (€2.42 in chips) 
Seat 4: CarlaBBruni (€4.19 in chips) 
Seat 5: McSup (€1.88 in chips) 
Seat 6: Warterror90 (€5.01 in chips) 
caduceus369: posts small blind €0.01
il_jack$$$58: posts big blind €0.02
*** HOLE CARDS ***
Dealt to caduceus369 [Ac 2h]
CarlaBBruni: raises €0.02 to €0.04
McSup: calls €0.04
Warterror90: folds 
uziu47: folds 
caduceus369: folds 
il_jack$$$58: calls €0.02
*** FLOP *** [6c 7d Kd]
il_jack$$$58: checks 
CarlaBBruni: checks 
McSup: checks 
*** TURN *** [6c 7d Kd] [5c]
il_jack$$$58: checks 
CarlaBBruni: bets €0.04
McSup: calls €0.04
il_jack$$$58: folds 
*** RIVER *** [6c 7d Kd 5c] [9c]
CarlaBBruni: checks 
McSup: bets €0.10
CarlaBBruni: folds 
Uncalled bet (€0.10) returned to McSup
McSup collected €0.20 from pot
McSup: doesn't show hand 
*** SUMMARY ***
Total pot €0.21 | Rake €0.01 
Board [6c 7d Kd 5c 9c]
Seat 1: uziu47 (button) folded before Flop (didn't bet)
Seat 2: caduceus369 (small blind) folded before Flop
Seat 3: il_jack$$$58 (big blind) folded on the Turn
Seat 4: CarlaBBruni folded on the River
Seat 5: McSup collected (€0.20)
Seat 6: Warterror90 folded before Flop (didn't bet)



PokerStars Zoom Hand #258129058631:  Hold'em No Limit (€0.01/€0.02) [ADM ID: M62C63044C87BABT] - 2025/10/15 0:58:38 CET [2025/10/14 18:58:38 ET]
Table 'Sirio' 6-max Seat #1 is the button
Seat 1: ilteatro131 (€2.06 in chips) 
Seat 2: il_jack$$$58 (€2.38 in chips) 
Seat 3: caduceus369 (€8.25 in chips) 
Seat 4: miridersa (€0.72 in chips) 
Seat 5: mashallahh (€8.73 in chips) 
Seat 6: uziu47 (€0.91 in chips) 
il_jack$$$58: posts small blind €0.01
caduceus369: posts big blind €0.02
*** HOLE CARDS ***
Dealt to caduceus369 [Ad 5h]
miridersa: calls €0.02
mashallahh: folds 
uziu47: folds 
ilteatro131: raises €0.02 to €0.04
il_jack$$$58: folds 
caduceus369: calls €0.02
miridersa: calls €0.02
*** FLOP *** [7s 7h 6s]
caduceus369: checks 
miridersa: checks 
ilteatro131: checks 
*** TURN *** [7s 7h 6s] [2h]
caduceus369: checks 
miridersa: checks 
ilteatro131: checks 
*** RIVER *** [7s 7h 6s 2h] [9h]
caduceus369: checks 
miridersa: checks 
ilteatro131: checks 
*** SHOW DOWN ***
caduceus369: shows [Ad 5h] (a pair of Sevens)
miridersa: mucks hand 
ilteatro131: mucks hand 
caduceus369 collected €0.13 from pot
*** SUMMARY ***
Total pot €0.13 | Rake €0 
Board [7s 7h 6s 2h 9h]
Seat 1: ilteatro131 (button) mucked [Qs Jc]
Seat 2: il_jack$$$58 (small blind) folded before Flop
Seat 3: caduceus369 (big blind) showed [Ad 5h] and won (€0.13) with a pair of Sevens
Seat 4: miridersa mucked [Qd 4d]
Seat 5: mashallahh folded before Flop (didn't bet)
Seat 6: uziu47 folded before Flop (didn't bet)



PokerStars Zoom Hand #258129069514:  Hold'em No Limit (€0.01/€0.02) [ADM ID: M62C63044C87BABT] - 2025/10/15 0:59:55 CET [2025/10/14 18:59:55 ET]
Table 'Sirio' 6-max Seat #1 is the button
Seat 1: caduceus369 (€8.34 in chips) 
Seat 2: Begimon (€11.75 in chips) 
Seat 3: father2008 (€2.38 in chips) 
Seat 4: mashallahh (€8.53 in chips) 
Seat 5: ADRIAN0_MEIS (€4.83 in chips) 
Seat 6: QUEEN-KING-QQKK (€2.84 in chips) 
Begimon: posts small blind €0.01
father2008: posts big blind €0.02
*** HOLE CARDS ***
Dealt to caduceus369 [4h 2s]
mashallahh: folds 
ADRIAN0_MEIS: folds 
QUEEN-KING-QQKK: folds 
caduceus369: folds 
Begimon: folds 
Uncalled bet (€0.01) returned to father2008
father2008 collected €0.02 from pot
father2008: doesn't show hand 
*** SUMMARY ***
Total pot €0.02 | Rake €0 
Seat 1: caduceus369 (button) folded before Flop (didn't bet)
Seat 2: Begimon (small blind) folded before Flop
Seat 3: father2008 (big blind) collected (€0.02)
Seat 4: mashallahh folded before Flop (didn't bet)
Seat 5: ADRIAN0_MEIS folded before Flop (didn't bet)
Seat 6: QUEEN-KING-QQKK folded before Flop (didn't bet)



PokerStars Zoom Hand #258129070186:  Hold'em No Limit (€0.01/€0.02) [ADM ID: M62C63044C87BABT] - 2025/10/15 1:00:00 CET [2025/10/14 19:00:00 ET]
Table 'Sirio' 6-max Seat #1 is the button
Seat 1: Begimon (€11.74 in chips) 
Seat 2: mashallahh (€8.53 in chips) 
Seat 3: ADRIAN0_MEIS (€4.83 in chips) 
Seat 4: caduceus369 (€8.34 in chips) 
Seat 5: Trezvenik93 (€3.04 in chips) 
mashallahh: posts small blind €0.01
ADRIAN0_MEIS: posts big blind €0.02
*** HOLE CARDS ***
Dealt to caduceus369 [7h Ad]
caduceus369: folds 
Trezvenik93: folds 
Begimon: folds 
mashallahh: folds 
Uncalled bet (€0.01) returned to ADRIAN0_MEIS
ADRIAN0_MEIS collected €0.02 from pot
ADRIAN0_MEIS: doesn't show hand 
*** SUMMARY ***
Total pot €0.02 | Rake €0 
Seat 1: Begimon (button) folded before Flop (didn't bet)
Seat 2: mashallahh (small blind) folded before Flop
Seat 3: ADRIAN0_MEIS (big blind) collected (€0.02)
Seat 4: caduceus369 folded before Flop (didn't bet)
Seat 5: Trezvenik93 folded before Flop (didn't bet)



PokerStars Zoom Hand #258129070840:  Hold'em No Limit (€0.01/€0.02) [ADM ID: M62C63044C87BABT] - 2025/10/15 1:00:04 CET [2025/10/14 19:00:04 ET]
Table 'Sirio' 6-max Seat #1 is the button
Seat 1: mashallahh (€5.47 in chips) 
Seat 2: father2008 (€2 in chips) 
Seat 3: caduceus369 (€8.34 in chips) 
Seat 4: il_jack$$$58 (€2.55 in chips) 
Seat 5: QUEEN-KING-QQKK (€2.84 in chips) 
Seat 6: Trezvenik93 (€3.04 in chips) 
father2008: posts small blind €0.01
caduceus369: posts big blind €0.02
*** HOLE CARDS ***
Dealt to caduceus369 [Qd 7h]
il_jack$$$58: folds 
QUEEN-KING-QQKK: folds 
Trezvenik93: folds 
mashallahh: folds 
father2008: folds 
Uncalled bet (€0.01) returned to caduceus369
caduceus369 collected €0.02 from pot
caduceus369: doesn't show hand 
*** SUMMARY ***
Total pot €0.02 | Rake €0 
Seat 1: mashallahh (button) folded before Flop (didn't bet)
Seat 2: father2008 (small blind) folded before Flop
Seat 3: caduceus369 (big blind) collected (€0.02)
Seat 4: il_jack$$$58 folded before Flop (didn't bet)
Seat 5: QUEEN-KING-QQKK folded before Flop (didn't bet)
Seat 6: Trezvenik93 folded before Flop (didn't bet)



PokerStars Zoom Hand #258129072160:  Hold'em No Limit (€0.01/€0.02) [ADM ID: M62C63044C87BABT] - 2025/10/15 1:00:13 CET [2025/10/14 19:00:13 ET]
Table 'Sirio' 6-max Seat #1 is the button
Seat 1: QUEEN-KING-QQKK (€2.83 in chips) 
Seat 2: caduceus369 (€8.35 in chips) 
Seat 3: uziu47 (€1.07 in chips) 
Seat 4: Plutonia72 (€1.84 in chips) 
Seat 5: miridersa (€0.66 in chips) 
Seat 6: ADRIAN0_MEIS (€4.84 in chips) 
caduceus369: posts small blind €0.01
uziu47: posts big blind €0.02
*** HOLE CARDS ***
Dealt to caduceus369 [4d Ad]
Plutonia72: folds 
miridersa: calls €0.02
ADRIAN0_MEIS: folds 
QUEEN-KING-QQKK: raises €0.07 to €0.09
caduceus369: folds 
uziu47: folds 
miridersa: folds 
Uncalled bet (€0.07) returned to QUEEN-KING-QQKK
QUEEN-KING-QQKK collected €0.07 from pot
QUEEN-KING-QQKK: doesn't show hand 
*** SUMMARY ***
Total pot €0.07 | Rake €0 
Seat 1: QUEEN-KING-QQKK (button) collected (€0.07)
Seat 2: caduceus369 (small blind) folded before Flop
Seat 3: uziu47 (big blind) folded before Flop
Seat 4: Plutonia72 folded before Flop (didn't bet)
Seat 5: miridersa folded before Flop
Seat 6: ADRIAN0_MEIS folded before Flop (didn't bet)



PokerStars Zoom Hand #258129078631:  Hold'em No Limit (€0.01/€0.02) [ADM ID: M62C63044C87BABT] - 2025/10/15 1:00:54 CET [2025/10/14 19:00:54 ET]
Table 'Sirio' 6-max Seat #1 is the button
Seat 1: uziu47 (€1.04 in chips) 
Seat 2: meteco79 (€1.30 in chips) 
Seat 3: QUEEN-KING-QQKK (€1.76 in chips) 
Seat 4: franck19621962 (€0.70 in chips) 
Seat 5: caduceus369 (€8.34 in chips) 
meteco79: posts small blind €0.01
QUEEN-KING-QQKK: posts big blind €0.02
*** HOLE CARDS ***
Dealt to caduceus369 [Kh Ah]
franck19621962: folds 
caduceus369: raises €0.04 to €0.06
uziu47: folds 
meteco79: calls €0.05
QUEEN-KING-QQKK: calls €0.04
*** FLOP *** [2c As 4d]
meteco79: checks 
QUEEN-KING-QQKK: checks 
caduceus369: bets €0.09
meteco79: folds 
QUEEN-KING-QQKK: folds 
Uncalled bet (€0.09) returned to caduceus369
caduceus369 collected €0.18 from pot
caduceus369: doesn't show hand 
*** SUMMARY ***
Total pot €0.18 | Rake €0 
Board [2c As 4d]
Seat 1: uziu47 (button) folded before Flop (didn't bet)
Seat 2: meteco79 (small blind) folded on the Flop
Seat 3: QUEEN-KING-QQKK (big blind) folded on the Flop
Seat 4: franck19621962 folded before Flop (didn't bet)
Seat 5: caduceus369 collected (€0.18)



PokerStars Zoom Hand #258129076744:  Hold'em No Limit (€0.01/€0.02) [ADM ID: M62C63044C87BABT] - 2025/10/15 1:00:43 CET [2025/10/14 19:00:43 ET]
Table 'Sirio' 6-max Seat #1 is the button
Seat 1: caduceus369 (€8.34 in chips) 
Seat 2: ADRIAN0_MEIS (€4.84 in chips) 
Seat 3: Poetto65 (€0.85 in chips) 
Seat 4: mashallahh (€8.09 in chips) 
Seat 5: franck19621962 (€0.70 in chips) 
ADRIAN0_MEIS: posts small blind €0.01
Poetto65: posts big blind €0.02
*** HOLE CARDS ***
Dealt to caduceus369 [8d Kc]
mashallahh: folds 
franck19621962: folds 
caduceus369: folds 
ADRIAN0_MEIS: raises €0.04 to €0.06
Poetto65: calls €0.04
*** FLOP *** [6d As 7c]
ADRIAN0_MEIS: bets €0.07
Poetto65: folds 
Uncalled bet (€0.07) returned to ADRIAN0_MEIS
ADRIAN0_MEIS collected €0.12 from pot
ADRIAN0_MEIS: doesn't show hand 
*** SUMMARY ***
Total pot €0.12 | Rake €0 
Board [6d As 7c]
Seat 1: caduceus369 (button) folded before Flop (didn't bet)
Seat 2: ADRIAN0_MEIS (small blind) collected (€0.12)
Seat 3: Poetto65 (big blind) folded on the Flop
Seat 4: mashallahh folded before Flop (didn't bet)
Seat 5: franck19621962 folded before Flop (didn't bet)



PokerStars Zoom Hand #258129086151:  Hold'em No Limit (€0.01/€0.02) [ADM ID: M62C63044C87BABT] - 2025/10/15 1:01:37 CET [2025/10/14 19:01:37 ET]
Table 'Sirio' 6-max Seat #1 is the button
Seat 1: mashallahh (€8.52 in chips) 
Seat 2: il_jack$$$58 (€2.90 in chips) 
Seat 3: SebaRapy14 (€3.26 in chips) 
Seat 4: caduceus369 (€8.46 in chips) 
Seat 5: father2008 (€2.03 in chips) 
il_jack$$$58: posts small blind €0.01
SebaRapy14: posts big blind €0.02
*** HOLE CARDS ***
Dealt to caduceus369 [4s Qh]
caduceus369: folds 
father2008: folds 
mashallahh: folds 
il_jack$$$58: folds 
Uncalled bet (€0.01) returned to SebaRapy14
SebaRapy14 collected €0.02 from pot
SebaRapy14: doesn't show hand 
*** SUMMARY ***
Total pot €0.02 | Rake €0 
Seat 1: mashallahh (button) folded before Flop (didn't bet)
Seat 2: il_jack$$$58 (small blind) folded before Flop
Seat 3: SebaRapy14 (big blind) collected (€0.02)
Seat 4: caduceus369 folded before Flop (didn't bet)
Seat 5: father2008 folded before Flop (didn't bet)



PokerStars Zoom Hand #258129084995:  Hold'em No Limit (€0.01/€0.02) [ADM ID: M62C63044C87BABT] - 2025/10/15 1:01:30 CET [2025/10/14 19:01:30 ET]
Table 'Sirio' 6-max Seat #1 is the button
Seat 1: franck19621962 (€0.71 in chips) 
Seat 2: QUEEN-KING-QQKK (€1.70 in chips) 
Seat 3: EasyToRule (€2.62 in chips) 
Seat 4: mashallahh (€8.06 in chips) 
Seat 5: ilteatro131 (€2.28 in chips) 
Seat 6: caduceus369 (€8.46 in chips) 
QUEEN-KING-QQKK: posts small blind €0.01
EasyToRule: posts big blind €0.02
*** HOLE CARDS ***
Dealt to caduceus369 [6h 8c]
mashallahh: folds 
ilteatro131: calls €0.02
caduceus369: folds 
franck19621962: calls €0.02
QUEEN-KING-QQKK: calls €0.01
EasyToRule: checks 
*** FLOP *** [Tc 4s 9d]
QUEEN-KING-QQKK: checks 
EasyToRule: checks 
ilteatro131: checks 
franck19621962: checks 
*** TURN *** [Tc 4s 9d] [4h]
QUEEN-KING-QQKK: checks 
EasyToRule: checks 
ilteatro131: checks 
franck19621962: checks 
*** RIVER *** [Tc 4s 9d 4h] [6c]
QUEEN-KING-QQKK: checks 
EasyToRule: checks 
ilteatro131: checks 
franck19621962: checks 
*** SHOW DOWN ***
QUEEN-KING-QQKK: shows [Ad 3h] (a pair of Fours)
EasyToRule: mucks hand 
ilteatro131: shows [6d As] (two pair, Sixes and Fours)
franck19621962: mucks hand 
ilteatro131 collected €0.08 from pot
*** SUMMARY ***
Total pot €0.08 | Rake €0 
Board [Tc 4s 9d 4h 6c]
Seat 1: franck19621962 (button) mucked [Qh Kd]
Seat 2: QUEEN-KING-QQKK (small blind) showed [Ad 3h] and lost with a pair of Fours
Seat 3: EasyToRule (big blind) mucked [7s 2d]
Seat 4: mashallahh folded before Flop (didn't bet)
Seat 5: ilteatro131 showed [6d As] and won (€0.08) with two pair, Sixes and Fours
Seat 6: caduceus369 folded before Flop (didn't bet)



PokerStars Zoom Hand #258129088344:  Hold'em No Limit (€0.01/€0.02) [ADM ID: M62C63044C87BABT] - 2025/10/15 1:01:49 CET [2025/10/14 19:01:49 ET]
Table 'Sirio' 6-max Seat #1 is the button
Seat 1: Warterror90 (€7.05 in chips) 
Seat 2: caduceus369 (€8.46 in chips) 
Seat 3: mashallahh (€8.52 in chips) 
Seat 4: il_jack$$$58 (€2.89 in chips) 
Seat 5: Poetto65 (€0.78 in chips) 
caduceus369: posts small blind €0.01
mashallahh: posts big blind €0.02
*** HOLE CARDS ***
Dealt to caduceus369 [8h 6c]
il_jack$$$58: folds 
Poetto65: folds 
Warterror90: raises €0.04 to €0.06
caduceus369: folds 
mashallahh: calls €0.04
*** FLOP *** [8c 3h 3d]
mashallahh: checks 
Warterror90: bets €0.05
mashallahh: folds 
Uncalled bet (€0.05) returned to Warterror90
Warterror90 collected €0.13 from pot
Warterror90: doesn't show hand 
*** SUMMARY ***
Total pot €0.13 | Rake €0 
Board [8c 3h 3d]
Seat 1: Warterror90 (button) collected (€0.13)
Seat 2: caduceus369 (small blind) folded before Flop
Seat 3: mashallahh (big blind) folded on the Flop
Seat 4: il_jack$$$58 folded before Flop (didn't bet)
Seat 5: Poetto65 folded before Flop (didn't bet)



PokerStars Zoom Hand #258129090940:  Hold'em No Limit (€0.01/€0.02) [ADM ID: M62C63044C87BABT] - 2025/10/15 1:02:03 CET [2025/10/14 19:02:03 ET]
Table 'Sirio' 6-max Seat #1 is the button
Seat 1: mashallahh (€8.08 in chips) 
Seat 2: father2008 (€2.03 in chips) 
Seat 3: caduceus369 (€8.45 in chips) 
Seat 4: meteco79 (€1.25 in chips) 
Seat 5: EasyToRule (€2 in chips) 
father2008: posts small blind €0.01
caduceus369: posts big blind €0.02
*** HOLE CARDS ***
Dealt to caduceus369 [Qh 4c]
meteco79: calls €0.02
EasyToRule: folds 
mashallahh: folds 
father2008: folds 
caduceus369: checks 
*** FLOP *** [Jd 4h 3c]
caduceus369: checks 
meteco79: bets €0.05
caduceus369: calls €0.05
*** TURN *** [Jd 4h 3c] [3h]
caduceus369: checks 
meteco79: checks 
*** RIVER *** [Jd 4h 3c 3h] [6h]
caduceus369: bets €0.04
meteco79: calls €0.04
*** SHOW DOWN ***
caduceus369: shows [Qh 4c] (two pair, Fours and Threes)
meteco79: shows [9c Jc] (two pair, Jacks and Threes)
meteco79 collected €0.22 from pot
*** SUMMARY ***
Total pot €0.23 | Rake €0.01 
Board [Jd 4h 3c 3h 6h]
Seat 1: mashallahh (button) folded before Flop (didn't bet)
Seat 2: father2008 (small blind) folded before Flop
Seat 3: caduceus369 (big blind) showed [Qh 4c] and lost with two pair, Fours and Threes
Seat 4: meteco79 showed [9c Jc] and won (€0.22) with two pair, Jacks and Threes
Seat 5: EasyToRule folded before Flop (didn't bet)



PokerStars Zoom Hand #258129098016:  Hold'em No Limit (€0.01/€0.02) [ADM ID: M62C63044C87BABT] - 2025/10/15 1:02:43 CET [2025/10/14 19:02:43 ET]
Table 'Sirio' 6-max Seat #1 is the button
Seat 1: caduceus369 (€8.34 in chips) 
Seat 2: Warterror90 (€6.81 in chips) 
Seat 3: Trezvenik93 (€2 in chips) 
Seat 4: mashallahh (€5.24 in chips) 
Seat 5: EasyToRule (€2.59 in chips) 
Warterror90: posts small blind €0.01
Trezvenik93: posts big blind €0.02
*** HOLE CARDS ***
Dealt to caduceus369 [Jh 2s]
mashallahh: folds 
EasyToRule: folds 
caduceus369: folds 
Warterror90: folds 
Uncalled bet (€0.01) returned to Trezvenik93
Trezvenik93 collected €0.02 from pot
Trezvenik93: doesn't show hand 
*** SUMMARY ***
Total pot €0.02 | Rake €0 
Seat 1: caduceus369 (button) folded before Flop (didn't bet)
Seat 2: Warterror90 (small blind) folded before Flop
Seat 3: Trezvenik93 (big blind) collected (€0.02)
Seat 4: mashallahh folded before Flop (didn't bet)
Seat 5: EasyToRule folded before Flop (didn't bet)



PokerStars Zoom Hand #258129098878:  Hold'em No Limit (€0.01/€0.02) [ADM ID: M62C63044C87BABT] - 2025/10/15 1:02:48 CET [2025/10/14 19:02:48 ET]
Table 'Sirio' 6-max Seat #1 is the button
Seat 1: father2008 (€2 in chips) 
Seat 2: caduceus369 (€8.34 in chips) 
Seat 3: Warterror90 (€7.12 in chips) 
Seat 4: EasyToRule (€2.59 in chips) 
Seat 5: mashallahh (€8.45 in chips) 
caduceus369: posts small blind €0.01
Warterror90: posts big blind €0.02
*** HOLE CARDS ***
Dealt to caduceus369 [7d Qd]
EasyToRule: folds 
mashallahh: folds 
father2008: raises €0.04 to €0.06
caduceus369: folds 
Warterror90: folds 
Uncalled bet (€0.04) returned to father2008
father2008 collected €0.05 from pot
father2008: doesn't show hand 
*** SUMMARY ***
Total pot €0.05 | Rake €0 
Seat 1: father2008 (button) collected (€0.05)
Seat 2: caduceus369 (small blind) folded before Flop
Seat 3: Warterror90 (big blind) folded before Flop
Seat 4: EasyToRule folded before Flop (didn't bet)
Seat 5: mashallahh folded before Flop (didn't bet)



PokerStars Zoom Hand #258129100166:  Hold'em No Limit (€0.01/€0.02) [ADM ID: M62C63044C87BABT] - 2025/10/15 1:02:55 CET [2025/10/14 19:02:55 ET]
Table 'Sirio' 6-max Seat #1 is the button
Seat 1: SebaRapy14 (€3.74 in chips) 
Seat 2: EasyToRule (€2.59 in chips) 
Seat 3: mashallahh (€5.24 in chips) 
Seat 4: ADRIAN0_MEIS (€4.95 in chips) 
Seat 5: caduceus369 (€8.33 in chips) 
EasyToRule: posts small blind €0.01
mashallahh: posts big blind €0.02
*** HOLE CARDS ***
Dealt to caduceus369 [Jh 9d]
ADRIAN0_MEIS: raises €0.05 to €0.07
caduceus369: folds 
SebaRapy14: folds 
EasyToRule: folds 
mashallahh: folds 
Uncalled bet (€0.05) returned to ADRIAN0_MEIS
ADRIAN0_MEIS collected €0.05 from pot
ADRIAN0_MEIS: doesn't show hand 
*** SUMMARY ***
Total pot €0.05 | Rake €0 
Seat 1: SebaRapy14 (button) folded before Flop (didn't bet)
Seat 2: EasyToRule (small blind) folded before Flop
Seat 3: mashallahh (big blind) folded before Flop
Seat 4: ADRIAN0_MEIS collected (€0.05)
Seat 5: caduceus369 folded before Flop (didn't bet)



PokerStars Zoom Hand #258129101143:  Hold'em No Limit (€0.01/€0.02) [ADM ID: M62C63044C87BABT] - 2025/10/15 1:03:00 CET [2025/10/14 19:03:00 ET]
Table 'Sirio' 6-max Seat #1 is the button
Seat 1: Trezvenik93 (€2 in chips) 
Seat 2: Warterror90 (€7.10 in chips) 
Seat 3: uziu47 (€1.47 in chips) 
Seat 4: mashallahh (€8.45 in chips) 
Seat 5: SebaRapy14 (€3.74 in chips) 
Seat 6: caduceus369 (€8.33 in chips) 
Warterror90: posts small blind €0.01
uziu47: posts big blind €0.02
*** HOLE CARDS ***
Dealt to caduceus369 [Jd 3c]
mashallahh: folds 
SebaRapy14: folds 
caduceus369: folds 
Trezvenik93: folds 
Warterror90: raises €0.04 to €0.06
uziu47: folds 
Uncalled bet (€0.04) returned to Warterror90
Warterror90 collected €0.04 from pot
Warterror90: doesn't show hand 
*** SUMMARY ***
Total pot €0.04 | Rake €0 
Seat 1: Trezvenik93 (button) folded before Flop (didn't bet)
Seat 2: Warterror90 (small blind) collected (€0.04)
Seat 3: uziu47 (big blind) folded before Flop
Seat 4: mashallahh folded before Flop (didn't bet)
Seat 5: SebaRapy14 folded before Flop (didn't bet)
Seat 6: caduceus369 folded before Flop (didn't bet)



PokerStars Zoom Hand #258129102155:  Hold'em No Limit (€0.01/€0.02) [ADM ID: M62C63044C87BABT] - 2025/10/15 1:03:06 CET [2025/10/14 19:03:06 ET]
Table 'Sirio' 6-max Seat #1 is the button
Seat 1: ADRIAN0_MEIS (€4.98 in chips) 
Seat 2: meteco79 (€1.32 in chips) 
Seat 3: Temait77728 (€2.40 in chips) 
Seat 4: mashallahh (€8.45 in chips) 
Seat 5: caduceus369 (€8.33 in chips) 
meteco79: posts small blind €0.01
Temait77728: posts big blind €0.02
*** HOLE CARDS ***
Dealt to caduceus369 [Ac Jc]
mashallahh: folds 
caduceus369: raises €0.04 to €0.06
ADRIAN0_MEIS: folds 
meteco79: calls €0.05
Temait77728: folds 
*** FLOP *** [6s 2s 8d]
meteco79: checks 
caduceus369: checks 
*** TURN *** [6s 2s 8d] [Ts]
meteco79: checks 
caduceus369: checks 
*** RIVER *** [6s 2s 8d Ts] [3s]
meteco79: bets €1.26 and is all-in
caduceus369: folds 
Uncalled bet (€1.26) returned to meteco79
meteco79 collected €0.14 from pot
meteco79: doesn't show hand 
*** SUMMARY ***
Total pot €0.14 | Rake €0 
Board [6s 2s 8d Ts 3s]
Seat 1: ADRIAN0_MEIS (button) folded before Flop (didn't bet)
Seat 2: meteco79 (small blind) collected (€0.14)
Seat 3: Temait77728 (big blind) folded before Flop
Seat 4: mashallahh folded before Flop (didn't bet)
Seat 5: caduceus369 folded on the River



PokerStars Zoom Hand #258129107610:  Hold'em No Limit (€0.01/€0.02) [ADM ID: M62C63044C87BABT] - 2025/10/15 1:03:37 CET [2025/10/14 19:03:37 ET]
Table 'Sirio' 6-max Seat #1 is the button
Seat 1: Poetto65 (€0.78 in chips) 
Seat 2: dandoshats (€1.98 in chips) 
Seat 3: SebaRapy14 (€3.77 in chips) 
Seat 4: caduceus369 (€8.27 in chips) 
Seat 5: mashallahh (€8.42 in chips) 
Seat 6: Warterror90 (€7.06 in chips) 
dandoshats: posts small blind €0.01
SebaRapy14: posts big blind €0.02
*** HOLE CARDS ***
Dealt to caduceus369 [Js Ac]
caduceus369: raises €0.04 to €0.06
mashallahh: folds 
Warterror90: folds 
Poetto65: calls €0.06
dandoshats: folds 
SebaRapy14: calls €0.04
*** FLOP *** [Jh 9d Kd]
SebaRapy14: checks 
caduceus369: checks 
Poetto65: bets €0.02
SebaRapy14: calls €0.02
caduceus369: calls €0.02
*** TURN *** [Jh 9d Kd] [Td]
SebaRapy14: checks 
caduceus369: checks 
Poetto65: checks 
*** RIVER *** [Jh 9d Kd Td] [6s]
SebaRapy14: bets €0.21
caduceus369: folds 
Poetto65: folds 
Uncalled bet (€0.21) returned to SebaRapy14
SebaRapy14 collected €0.24 from pot
SebaRapy14: doesn't show hand 
*** SUMMARY ***
Total pot €0.25 | Rake €0.01 
Board [Jh 9d Kd Td 6s]
Seat 1: Poetto65 (button) folded on the River
Seat 2: dandoshats (small blind) folded before Flop
Seat 3: SebaRapy14 (big blind) collected (€0.24)
Seat 4: caduceus369 folded on the River
Seat 5: mashallahh folded before Flop (didn't bet)
Seat 6: Warterror90 folded before Flop (didn't bet)



PokerStars Zoom Hand #258129125531:  Hold'em No Limit (€0.01/€0.02) [ADM ID: M62C63044C87BABT] - 2025/10/15 1:05:18 CET [2025/10/14 19:05:18 ET]
Table 'Sirio' 6-max Seat #1 is the button
Seat 1: caduceus369 (€8.13 in chips) 
Seat 2: mashallahh (€8.16 in chips) 
Seat 3: CIKO71131 (€0.80 in chips) 
Seat 4: father2008 (€2.34 in chips) 
Seat 5: Warterror90 (€7.10 in chips) 
Seat 6: dandoshats (€2.19 in chips) 
mashallahh: posts small blind €0.01
CIKO71131: posts big blind €0.02
*** HOLE CARDS ***
Dealt to caduceus369 [As Ah]
father2008: folds 
Warterror90: folds 
dandoshats: folds 
caduceus369: raises €0.04 to €0.06
mashallahh: folds 
CIKO71131: folds 
Uncalled bet (€0.04) returned to caduceus369
caduceus369 collected €0.05 from pot
caduceus369: doesn't show hand 
*** SUMMARY ***
Total pot €0.05 | Rake €0 
Seat 1: caduceus369 (button) collected (€0.05)
Seat 2: mashallahh (small blind) folded before Flop
Seat 3: CIKO71131 (big blind) folded before Flop
Seat 4: father2008 folded before Flop (didn't bet)
Seat 5: Warterror90 folded before Flop (didn't bet)
Seat 6: dandoshats folded before Flop (didn't bet)



PokerStars Zoom Hand #258129117182:  Hold'em No Limit (€0.01/€0.02) [ADM ID: M62C63044C87BABT] - 2025/10/15 1:04:31 CET [2025/10/14 19:04:31 ET]
Table 'Sirio' 6-max Seat #1 is the button
Seat 1: mashallahh (€5.19 in chips) 
Seat 2: Trezvenik93 (€2 in chips) 
Seat 3: caduceus369 (€8.19 in chips) 
Seat 4: QUEEN-KING-QQKK (€1.63 in chips) 
Seat 5: meteco79 (€1.77 in chips) 
Trezvenik93: posts small blind €0.01
caduceus369: posts big blind €0.02
*** HOLE CARDS ***
Dealt to caduceus369 [5s 5d]
QUEEN-KING-QQKK: folds 
meteco79: folds 
mashallahh: raises €0.04 to €0.06
Trezvenik93: calls €0.05
caduceus369: calls €0.04
*** FLOP *** [Ad Kc Tc]
Trezvenik93: checks 
caduceus369: checks 
mashallahh: bets €0.14
Trezvenik93: calls €0.14
caduceus369: folds 
*** TURN *** [Ad Kc Tc] [Ks]
Trezvenik93: checks 
mashallahh: checks 
*** RIVER *** [Ad Kc Tc Ks] [Jc]
Trezvenik93: bets €0.28
mashallahh: calls €0.28
*** SHOW DOWN ***
Trezvenik93: shows [9c 8c] (a flush, King high)
mashallahh: mucks hand 
Trezvenik93 collected €0.97 from pot
*** SUMMARY ***
Total pot €1.02 | Rake €0.05 
Board [Ad Kc Tc Ks Jc]
Seat 1: mashallahh (button) mucked [Js Ah]
Seat 2: Trezvenik93 (small blind) showed [9c 8c] and won (€0.97) with a flush, King high
Seat 3: caduceus369 (big blind) folded on the Flop
Seat 4: QUEEN-KING-QQKK folded before Flop (didn't bet)
Seat 5: meteco79 folded before Flop (didn't bet)



PokerStars Zoom Hand #258129132279:  Hold'em No Limit (€0.01/€0.02) [ADM ID: M62C63044C87BABT] - 2025/10/15 1:05:56 CET [2025/10/14 19:05:56 ET]
Table 'Sirio' 6-max Seat #1 is the button
Seat 1: Begimon (€11.35 in chips) 
Seat 2: caduceus369 (€8.16 in chips) 
Seat 3: dandoshats (€2.06 in chips) 
Seat 4: EasyToRule (€2.33 in chips) 
Seat 5: mashallahh (€2.91 in chips) 
caduceus369: posts small blind €0.01
dandoshats: posts big blind €0.02
*** HOLE CARDS ***
Dealt to caduceus369 [6d 9h]
EasyToRule: folds 
mashallahh: folds 
Begimon: folds 
caduceus369: folds 
Uncalled bet (€0.01) returned to dandoshats
dandoshats collected €0.02 from pot
dandoshats: doesn't show hand 
*** SUMMARY ***
Total pot €0.02 | Rake €0 
Seat 1: Begimon (button) folded before Flop (didn't bet)
Seat 2: caduceus369 (small blind) folded before Flop
Seat 3: dandoshats (big blind) collected (€0.02)
Seat 4: EasyToRule folded before Flop (didn't bet)
Seat 5: mashallahh folded before Flop (didn't bet)



PokerStars Zoom Hand #258129130682:  Hold'em No Limit (€0.01/€0.02) [ADM ID: M62C63044C87BABT] - 2025/10/15 1:05:47 CET [2025/10/14 19:05:47 ET]
Table 'Sirio' 6-max Seat #1 is the button
Seat 1: dandoshats (€2.06 in chips) 
Seat 2: uziu47 (€1.87 in chips) 
Seat 3: Warterror90 (€7.19 in chips) 
Seat 4: SebaRapy14 (€3.62 in chips) 
Seat 5: caduceus369 (€8.16 in chips) 
uziu47: posts small blind €0.01
Warterror90: posts big blind €0.02
*** HOLE CARDS ***
Dealt to caduceus369 [5c Kd]
SebaRapy14: folds 
caduceus369: folds 
dandoshats: folds 
uziu47: calls €0.01
Warterror90: checks 
*** FLOP *** [7d 8c 6c]
uziu47: checks 
Warterror90: checks 
*** TURN *** [7d 8c 6c] [Ts]
uziu47: checks 
Warterror90: checks 
*** RIVER *** [7d 8c 6c Ts] [Jd]
uziu47: checks 
Warterror90: checks 
*** SHOW DOWN ***
uziu47: shows [6s As] (a pair of Sixes)
Warterror90: shows [Js 2c] (a pair of Jacks)
Warterror90 collected €0.04 from pot
*** SUMMARY ***
Total pot €0.04 | Rake €0 
Board [7d 8c 6c Ts Jd]
Seat 1: dandoshats (button) folded before Flop (didn't bet)
Seat 2: uziu47 (small blind) showed [6s As] and lost with a pair of Sixes
Seat 3: Warterror90 (big blind) showed [Js 2c] and won (€0.04) with a pair of Jacks
Seat 4: SebaRapy14 folded before Flop (didn't bet)
Seat 5: caduceus369 folded before Flop (didn't bet)



PokerStars Zoom Hand #258129131429:  Hold'em No Limit (€0.01/€0.02) [ADM ID: M62C63044C87BABT] - 2025/10/15 1:05:52 CET [2025/10/14 19:05:52 ET]
Table 'Sirio' 6-max Seat #1 is the button
Seat 1: CIKO71131 (€0.77 in chips) 
Seat 2: mashallahh (€4.71 in chips) 
Seat 3: SebaRapy14 (€3.62 in chips) 
Seat 4: caduceus369 (€8.16 in chips) 
Seat 5: Warterror90 (€7.10 in chips) 
Seat 6: Trezvenik93 (€2.75 in chips) 
mashallahh: posts small blind €0.01
SebaRapy14: posts big blind €0.02
*** HOLE CARDS ***
Dealt to caduceus369 [4s Qs]
caduceus369: folds 
Warterror90: raises €0.04 to €0.06
Trezvenik93: folds 
CIKO71131: calls €0.06
mashallahh: folds 
SebaRapy14: calls €0.04
*** FLOP *** [Ts 5h 7d]
SebaRapy14: checks 
Warterror90: checks 
CIKO71131: checks 
*** TURN *** [Ts 5h 7d] [5c]
SebaRapy14: checks 
Warterror90: checks 
CIKO71131: checks 
*** RIVER *** [Ts 5h 7d 5c] [9c]
SebaRapy14: checks 
Warterror90: checks 
CIKO71131: checks 
*** SHOW DOWN ***
SebaRapy14: shows [Jh As] (a pair of Fives)
Warterror90: mucks hand 
CIKO71131: mucks hand 
SebaRapy14 collected €0.18 from pot
*** SUMMARY ***
Total pot €0.19 | Rake €0.01 
Board [Ts 5h 7d 5c 9c]
Seat 1: CIKO71131 (button) mucked [Ad 8h]
Seat 2: mashallahh (small blind) folded before Flop
Seat 3: SebaRapy14 (big blind) showed [Jh As] and won (€0.18) with a pair of Fives
Seat 4: caduceus369 folded before Flop (didn't bet)
Seat 5: Warterror90 mucked [2h 3h]
Seat 6: Trezvenik93 folded before Flop (didn't bet)



PokerStars Zoom Hand #258129134359:  Hold'em No Limit (€0.01/€0.02) [ADM ID: M62C63044C87BABT] - 2025/10/15 1:06:08 CET [2025/10/14 19:06:08 ET]
Table 'Sirio' 6-max Seat #1 is the button
Seat 1: Temait77728 (€2.20 in chips) 
Seat 2: mashallahh (€2.91 in chips) 
Seat 3: caduceus369 (€8.15 in chips) 
Seat 4: QUEEN-KING-QQKK (€1.66 in chips) 
Seat 5: dandoshats (€2.07 in chips) 
mashallahh: posts small blind €0.01
caduceus369: posts big blind €0.02
*** HOLE CARDS ***
Dealt to caduceus369 [9c 5h]
QUEEN-KING-QQKK: folds 
dandoshats: raises €0.05 to €0.07
Temait77728: folds 
mashallahh: folds 
caduceus369: folds 
Uncalled bet (€0.05) returned to dandoshats
dandoshats collected €0.05 from pot
dandoshats: doesn't show hand 
*** SUMMARY ***
Total pot €0.05 | Rake €0 
Seat 1: Temait77728 (button) folded before Flop (didn't bet)
Seat 2: mashallahh (small blind) folded before Flop
Seat 3: caduceus369 (big blind) folded before Flop
Seat 4: QUEEN-KING-QQKK folded before Flop (didn't bet)
Seat 5: dandoshats collected (€0.05)



PokerStars Zoom Hand #258129137770:  Hold'em No Limit (€0.01/€0.02) [ADM ID: M62C63044C87BABT] - 2025/10/15 1:06:28 CET [2025/10/14 19:06:28 ET]
Table 'Sirio' 6-max Seat #1 is the button
Seat 1: caduceus369 (€8.13 in chips) 
Seat 2: Warterror90 (€7.04 in chips) 
Seat 3: mashallahh (€2.90 in chips) 
Seat 4: father2008 (€2.15 in chips) 
Seat 5: CIKO71131 (€0.71 in chips) 
Seat 6: SebaRapy14 (€3.74 in chips) 
Warterror90: posts small blind €0.01
mashallahh: posts big blind €0.02
*** HOLE CARDS ***
Dealt to caduceus369 [Kd Tc]
father2008: folds 
CIKO71131: folds 
SebaRapy14: folds 
caduceus369: raises €0.04 to €0.06
Warterror90: folds 
mashallahh: calls €0.04
*** FLOP *** [9d 7h Jh]
mashallahh: checks 
caduceus369: bets €0.07
mashallahh: folds 
Uncalled bet (€0.07) returned to caduceus369
caduceus369 collected €0.13 from pot
caduceus369: doesn't show hand 
*** SUMMARY ***
Total pot €0.13 | Rake €0 
Board [9d 7h Jh]
Seat 1: caduceus369 (button) collected (€0.13)
Seat 2: Warterror90 (small blind) folded before Flop
Seat 3: mashallahh (big blind) folded on the Flop
Seat 4: father2008 folded before Flop (didn't bet)
Seat 5: CIKO71131 folded before Flop (didn't bet)
Seat 6: SebaRapy14 folded before Flop (didn't bet)



PokerStars Zoom Hand #258129133669:  Hold'em No Limit (€0.01/€0.02) [ADM ID: M62C63044C87BABT] - 2025/10/15 1:06:04 CET [2025/10/14 19:06:04 ET]
Table 'Sirio' 6-max Seat #1 is the button
Seat 1: mashallahh (€8.16 in chips) 
Seat 2: Begimon (€11.35 in chips) 
Seat 3: CIKO71131 (€0.80 in chips) 
Seat 4: caduceus369 (€8.15 in chips) 
Seat 5: Trezvenik93 (€2.75 in chips) 
Begimon: posts small blind €0.01
CIKO71131: posts big blind €0.02
*** HOLE CARDS ***
Dealt to caduceus369 [2h Jc]
caduceus369: folds 
Trezvenik93: folds 
mashallahh: raises €0.04 to €0.06
Begimon: folds 
CIKO71131: calls €0.04
*** FLOP *** [7s 7c 9d]
CIKO71131: checks 
mashallahh: bets €0.09
CIKO71131: calls €0.09
*** TURN *** [7s 7c 9d] [Qc]
CIKO71131: checks 
mashallahh: checks 
*** RIVER *** [7s 7c 9d Qc] [Td]
CIKO71131: bets €0.08
mashallahh: calls €0.08
*** SHOW DOWN ***
CIKO71131: shows [5s 5c] (two pair, Sevens and Fives)
mashallahh: mucks hand 
CIKO71131 collected €0.45 from pot
*** SUMMARY ***
Total pot €0.47 | Rake €0.02 
Board [7s 7c 9d Qc Td]
Seat 1: mashallahh (button) mucked [As Kc]
Seat 2: Begimon (small blind) folded before Flop
Seat 3: CIKO71131 (big blind) showed [5s 5c] and won (€0.45) with two pair, Sevens and Fives
Seat 4: caduceus369 folded before Flop (didn't bet)
Seat 5: Trezvenik93 folded before Flop (didn't bet)



PokerStars Zoom Hand #258129143255:  Hold'em No Limit (€0.01/€0.02) [ADM ID: M62C63044C87BABT] - 2025/10/15 1:07:00 CET [2025/10/14 19:07:00 ET]
Table 'Sirio' 6-max Seat #1 is the button
Seat 1: QUEEN-KING-QQKK (€1.72 in chips) 
Seat 2: Trezvenik93 (€2.90 in chips) 
Seat 3: mashallahh (€4.69 in chips) 
Seat 4: EasyToRule (€2.33 in chips) 
Seat 5: caduceus369 (€8.20 in chips) 
Trezvenik93: posts small blind €0.01
mashallahh: posts big blind €0.02
*** HOLE CARDS ***
Dealt to caduceus369 [Js 2c]
EasyToRule: folds 
caduceus369: folds 
QUEEN-KING-QQKK: raises €0.05 to €0.07
Trezvenik93: folds 
mashallahh: folds 
Uncalled bet (€0.05) returned to QUEEN-KING-QQKK
QUEEN-KING-QQKK collected €0.05 from pot
QUEEN-KING-QQKK: doesn't show hand 
*** SUMMARY ***
Total pot €0.05 | Rake €0 
Seat 1: QUEEN-KING-QQKK (button) collected (€0.05)
Seat 2: Trezvenik93 (small blind) folded before Flop
Seat 3: mashallahh (big blind) folded before Flop
Seat 4: EasyToRule folded before Flop (didn't bet)
Seat 5: caduceus369 folded before Flop (didn't bet)



PokerStars Zoom Hand #258129146211:  Hold'em No Limit (€0.01/€0.02) [ADM ID: M62C63044C87BABT] - 2025/10/15 1:07:17 CET [2025/10/14 19:07:17 ET]
Table 'Sirio' 6-max Seat #1 is the button
Seat 1: Warterror90 (€4.03 in chips) 
Seat 2: caduceus369 (€8.20 in chips) 
Seat 3: CIKO71131 (€0.62 in chips) 
Seat 4: dandoshats (€1.94 in chips) 
Seat 5: mashallahh (€8.44 in chips) 
caduceus369: posts small blind €0.01
CIKO71131: posts big blind €0.02
*** HOLE CARDS ***
Dealt to caduceus369 [Kh 9c]
dandoshats: folds 
mashallahh: folds 
Warterror90: raises €0.04 to €0.06
caduceus369: folds 
CIKO71131: folds 
Uncalled bet (€0.04) returned to Warterror90
Warterror90 collected €0.05 from pot
Warterror90: doesn't show hand 
*** SUMMARY ***
Total pot €0.05 | Rake €0 
Seat 1: Warterror90 (button) collected (€0.05)
Seat 2: caduceus369 (small blind) folded before Flop
Seat 3: CIKO71131 (big blind) folded before Flop
Seat 4: dandoshats folded before Flop (didn't bet)
Seat 5: mashallahh folded before Flop (didn't bet)



PokerStars Zoom Hand #258129148297:  Hold'em No Limit (€0.01/€0.02) [ADM ID: M62C63044C87BABT] - 2025/10/15 1:07:29 CET [2025/10/14 19:07:29 ET]
Table 'Sirio' 6-max Seat #1 is the button
Seat 1: caduceus369 (€8.19 in chips) 
Seat 2: SebaRapy14 (€3.74 in chips) 
Seat 3: EasyToRule (€2.36 in chips) 
Seat 4: mashallahh (€8.44 in chips) 
Seat 5: ADRIAN0_MEIS (€5.25 in chips) 
Seat 6: Warterror90 (€7.21 in chips) 
SebaRapy14: posts small blind €0.01
EasyToRule: posts big blind €0.02
*** HOLE CARDS ***
Dealt to caduceus369 [Ts Td]
mashallahh: folds 
ADRIAN0_MEIS: folds 
Warterror90: raises €0.04 to €0.06
caduceus369: raises €0.12 to €0.18
SebaRapy14: folds 
EasyToRule: folds 
Warterror90: calls €0.12
*** FLOP *** [Qh Qs Ah]
Warterror90: checks 
caduceus369: bets €0.19
Warterror90: folds 
Uncalled bet (€0.19) returned to caduceus369
caduceus369 collected €0.37 from pot
caduceus369: doesn't show hand 
*** SUMMARY ***
Total pot €0.39 | Rake €0.02 
Board [Qh Qs Ah]
Seat 1: caduceus369 (button) collected (€0.37)
Seat 2: SebaRapy14 (small blind) folded before Flop
Seat 3: EasyToRule (big blind) folded before Flop
Seat 4: mashallahh folded before Flop (didn't bet)
Seat 5: ADRIAN0_MEIS folded before Flop (didn't bet)
Seat 6: Warterror90 folded on the Flop



PokerStars Zoom Hand #258129157806:  Hold'em No Limit (€0.01/€0.02) [ADM ID: M62C63044C87BABT] - 2025/10/15 1:08:25 CET [2025/10/14 19:08:25 ET]
Table 'Sirio' 6-max Seat #1 is the button
Seat 1: Begimon (€11.26 in chips) 
Seat 2: meteco79 (€1.67 in chips) 
Seat 3: caduceus369 (€8.38 in chips) 
Seat 4: mashallahh (€2.84 in chips) 
Seat 5: CIKO71131 (€0.57 in chips) 
meteco79: posts small blind €0.01
caduceus369: posts big blind €0.02
*** HOLE CARDS ***
Dealt to caduceus369 [As Kd]
mashallahh: folds 
CIKO71131: folds 
Begimon: calls €0.02
meteco79: calls €0.01
caduceus369: raises €0.06 to €0.08
Begimon: calls €0.06
meteco79: calls €0.06
*** FLOP *** [7s 2s 7d]
meteco79: checks 
caduceus369: bets €0.08
Begimon: calls €0.08
meteco79: folds 
*** TURN *** [7s 2s 7d] [9d]
caduceus369: checks 
Begimon: checks 
*** RIVER *** [7s 2s 7d 9d] [9c]
caduceus369: bets €0.19
Begimon: folds 
Uncalled bet (€0.19) returned to caduceus369
caduceus369 collected €0.38 from pot
caduceus369: doesn't show hand 
*** SUMMARY ***
Total pot €0.40 | Rake €0.02 
Board [7s 2s 7d 9d 9c]
Seat 1: Begimon (button) folded on the River
Seat 2: meteco79 (small blind) folded on the Flop
Seat 3: caduceus369 (big blind) collected (€0.38)
Seat 4: mashallahh folded before Flop (didn't bet)
Seat 5: CIKO71131 folded before Flop (didn't bet)



PokerStars Zoom Hand #258129166789:  Hold'em No Limit (€0.01/€0.02) [ADM ID: M62C63044C87BABT] - 2025/10/15 1:09:18 CET [2025/10/14 19:09:18 ET]
Table 'Sirio' 6-max Seat #1 is the button
Seat 1: CIKO71131 (€0.96 in chips) 
Seat 2: caduceus369 (€8.60 in chips) 
Seat 3: QUEEN-KING-QQKK (€1.83 in chips) 
Seat 4: mashallahh (€4.91 in chips) 
Seat 5: dandoshats (€1.79 in chips) 
caduceus369: posts small blind €0.01
QUEEN-KING-QQKK: posts big blind €0.02
*** HOLE CARDS ***
Dealt to caduceus369 [7s 8s]
mashallahh: folds 
dandoshats: raises €0.02 to €0.04
CIKO71131: calls €0.04
caduceus369: folds 
QUEEN-KING-QQKK: folds 
*** FLOP *** [3c 5h Td]
dandoshats: checks 
CIKO71131: checks 
*** TURN *** [3c 5h Td] [9c]
dandoshats: checks 
CIKO71131: checks 
*** RIVER *** [3c 5h Td 9c] [Jc]
dandoshats: checks 
CIKO71131: checks 
*** SHOW DOWN ***
dandoshats: shows [6d 6c] (a pair of Sixes)
CIKO71131: mucks hand 
dandoshats collected €0.11 from pot
*** SUMMARY ***
Total pot €0.11 | Rake €0 
Board [3c 5h Td 9c Jc]
Seat 1: CIKO71131 (button) mucked [7h 3h]
Seat 2: caduceus369 (small blind) folded before Flop
Seat 3: QUEEN-KING-QQKK (big blind) folded before Flop
Seat 4: mashallahh folded before Flop (didn't bet)
Seat 5: dandoshats showed [6d 6c] and won (€0.11) with a pair of Sixes



PokerStars Zoom Hand #258129169010:  Hold'em No Limit (€0.01/€0.02) [ADM ID: M62C63044C87BABT] - 2025/10/15 1:09:31 CET [2025/10/14 19:09:31 ET]
Table 'Sirio' 6-max Seat #1 is the button
Seat 1: caduceus369 (€8.59 in chips) 
Seat 2: bartolo608 (€2.11 in chips) 
Seat 3: Macantoni (€0.80 in chips) 
Seat 4: Temait77728 (€2.31 in chips) 
Seat 5: mashallahh (€8.38 in chips) 
bartolo608: posts small blind €0.01
Macantoni: posts big blind €0.02
*** HOLE CARDS ***
Dealt to caduceus369 [Jc 4d]
Temait77728: folds 
mashallahh: folds 
caduceus369: folds 
bartolo608: calls €0.01
Macantoni: checks 
*** FLOP *** [8h Ac 7h]
bartolo608: checks 
Macantoni: checks 
*** TURN *** [8h Ac 7h] [2d]
bartolo608: checks 
Macantoni: bets €0.02
bartolo608: calls €0.02
*** RIVER *** [8h Ac 7h 2d] [4s]
bartolo608: checks 
Macantoni: bets €0.02
bartolo608: calls €0.02
*** SHOW DOWN ***
Macantoni: shows [Tc 5h] (high card Ace)
bartolo608: shows [Kc 4c] (a pair of Fours)
bartolo608 collected €0.12 from pot
*** SUMMARY ***
Total pot €0.12 | Rake €0 
Board [8h Ac 7h 2d 4s]
Seat 1: caduceus369 (button) folded before Flop (didn't bet)
Seat 2: bartolo608 (small blind) showed [Kc 4c] and won (€0.12) with a pair of Fours
Seat 3: Macantoni (big blind) showed [Tc 5h] and lost with high card Ace
Seat 4: Temait77728 folded before Flop (didn't bet)
Seat 5: mashallahh folded before Flop (didn't bet)



PokerStars Zoom Hand #258129171831:  Hold'em No Limit (€0.01/€0.02) [ADM ID: M62C63044C87BABT] - 2025/10/15 1:09:48 CET [2025/10/14 19:09:48 ET]
Table 'Sirio' 6-max Seat #1 is the button
Seat 1: QUEEN-KING-QQKK (€3.22 in chips) 
Seat 2: father2008 (€2 in chips) 
Seat 3: mashallahh (€2.81 in chips) 
Seat 4: dandoshats (€1.86 in chips) 
Seat 5: caduceus369 (€8.59 in chips) 
father2008: posts small blind €0.01
mashallahh: posts big blind €0.02
*** HOLE CARDS ***
Dealt to caduceus369 [Kh Qc]
dandoshats: raises €0.04 to €0.06
caduceus369: raises €0.12 to €0.18
QUEEN-KING-QQKK: folds 
father2008: folds 
mashallahh: folds 
dandoshats: calls €0.12
*** FLOP *** [9d 8s 7d]
dandoshats: checks 
caduceus369: checks 
*** TURN *** [9d 8s 7d] [8d]
dandoshats: bets €0.21
caduceus369: folds 
Uncalled bet (€0.21) returned to dandoshats
dandoshats collected €0.37 from pot
dandoshats: doesn't show hand 
*** SUMMARY ***
Total pot €0.39 | Rake €0.02 
Board [9d 8s 7d 8d]
Seat 1: QUEEN-KING-QQKK (button) folded before Flop (didn't bet)
Seat 2: father2008 (small blind) folded before Flop
Seat 3: mashallahh (big blind) folded before Flop
Seat 4: dandoshats collected (€0.37)
Seat 5: caduceus369 folded on the Turn



PokerStars Zoom Hand #258129168221:  Hold'em No Limit (€0.01/€0.02) [ADM ID: M62C63044C87BABT] - 2025/10/15 1:09:27 CET [2025/10/14 19:09:27 ET]
Table 'Sirio' 6-max Seat #1 is the button
Seat 1: mashallahh (€2.81 in chips) 
Seat 2: QUEEN-KING-QQKK (€1.81 in chips) 
Seat 3: ilteatro131 (€1.43 in chips) 
Seat 4: caduceus369 (€8.59 in chips) 
Seat 5: ADRIAN0_MEIS (€5.51 in chips) 
Seat 6: Begimon (€11.05 in chips) 
QUEEN-KING-QQKK: posts small blind €0.01
ilteatro131: posts big blind €0.02
*** HOLE CARDS ***
Dealt to caduceus369 [2h As]
caduceus369: folds 
ADRIAN0_MEIS: folds 
Begimon: calls €0.02
mashallahh: folds 
QUEEN-KING-QQKK: calls €0.01
ilteatro131: checks 
*** FLOP *** [Ad 7d 3h]
QUEEN-KING-QQKK: checks 
ilteatro131: checks 
Begimon: checks 
*** TURN *** [Ad 7d 3h] [9d]
QUEEN-KING-QQKK: checks 
ilteatro131: checks 
Begimon: checks 
*** RIVER *** [Ad 7d 3h 9d] [Th]
QUEEN-KING-QQKK: checks 
ilteatro131: checks 
Begimon: checks 
*** SHOW DOWN ***
QUEEN-KING-QQKK: shows [Js Tc] (a pair of Tens)
ilteatro131: mucks hand 
Begimon: mucks hand 
QUEEN-KING-QQKK collected €0.06 from pot
*** SUMMARY ***
Total pot €0.06 | Rake €0 
Board [Ad 7d 3h 9d Th]
Seat 1: mashallahh (button) folded before Flop (didn't bet)
Seat 2: QUEEN-KING-QQKK (small blind) showed [Js Tc] and won (€0.06) with a pair of Tens
Seat 3: ilteatro131 (big blind) mucked [5s 2d]
Seat 4: caduceus369 folded before Flop (didn't bet)
Seat 5: ADRIAN0_MEIS folded before Flop (didn't bet)
Seat 6: Begimon mucked [Kd Qs]



PokerStars Zoom Hand #258129170796:  Hold'em No Limit (€0.01/€0.02) [ADM ID: M62C63044C87BABT] - 2025/10/15 1:09:42 CET [2025/10/14 19:09:42 ET]
Table 'Sirio' 6-max Seat #1 is the button
Seat 1: Trezvenik93 (€2.44 in chips) 
Seat 2: CIKO71131 (€0.92 in chips) 
Seat 3: ormaxam (€2 in chips) 
Seat 4: mashallahh (€2.81 in chips) 
Seat 5: caduceus369 (€8.59 in chips) 
Seat 6: dandoshats (€1.86 in chips) 
CIKO71131: posts small blind €0.01
ormaxam: posts big blind €0.02
*** HOLE CARDS ***
Dealt to caduceus369 [8h 6d]
mashallahh: folds 
caduceus369: folds 
dandoshats: folds 
Trezvenik93: folds 
CIKO71131: calls €0.01
ormaxam: checks 
*** FLOP *** [9s Jd 3s]
CIKO71131: checks 
ormaxam: checks 
*** TURN *** [9s Jd 3s] [Td]
CIKO71131: bets €0.02
ormaxam: calls €0.02
*** RIVER *** [9s Jd 3s Td] [6h]
CIKO71131: checks 
ormaxam: checks 
*** SHOW DOWN ***
CIKO71131: shows [9c 9d] (three of a kind, Nines)
ormaxam: mucks hand 
CIKO71131 collected €0.08 from pot
*** SUMMARY ***
Total pot €0.08 | Rake €0 
Board [9s Jd 3s Td 6h]
Seat 1: Trezvenik93 (button) folded before Flop (didn't bet)
Seat 2: CIKO71131 (small blind) showed [9c 9d] and won (€0.08) with three of a kind, Nines
Seat 3: ormaxam (big blind) mucked [Qd 6c]
Seat 4: mashallahh folded before Flop (didn't bet)
Seat 5: caduceus369 folded before Flop (didn't bet)
Seat 6: dandoshats folded before Flop (didn't bet)



PokerStars Zoom Hand #258129177495:  Hold'em No Limit (€0.01/€0.02) [ADM ID: M62C63044C87BABT] - 2025/10/15 1:10:23 CET [2025/10/14 19:10:23 ET]
Table 'Sirio' 6-max Seat #1 is the button
Seat 1: EasyToRule (€2.27 in chips) 
Seat 2: uziu47 (€1.78 in chips) 
Seat 3: caduceus369 (€8.41 in chips) 
Seat 4: father2008 (€2.03 in chips) 
Seat 5: franck19621962 (€1.21 in chips) 
Seat 6: mashallahh (€7.98 in chips) 
uziu47: posts small blind €0.01
caduceus369: posts big blind €0.02
*** HOLE CARDS ***
Dealt to caduceus369 [7h 3d]
father2008: folds 
franck19621962: calls €0.02
mashallahh: folds 
EasyToRule: folds 
uziu47: calls €0.01
caduceus369: checks 
*** FLOP *** [Ad 6c Qs]
uziu47: bets €0.02
caduceus369: folds 
franck19621962: calls €0.02
*** TURN *** [Ad 6c Qs] [Ac]
uziu47: bets €0.06
franck19621962: folds 
Uncalled bet (€0.06) returned to uziu47
uziu47 collected €0.10 from pot
uziu47: doesn't show hand 
*** SUMMARY ***
Total pot €0.10 | Rake €0 
Board [Ad 6c Qs Ac]
Seat 1: EasyToRule (button) folded before Flop (didn't bet)
Seat 2: uziu47 (small blind) collected (€0.10)
Seat 3: caduceus369 (big blind) folded on the Flop
Seat 4: father2008 folded before Flop (didn't bet)
Seat 5: franck19621962 folded on the Turn
Seat 6: mashallahh folded before Flop (didn't bet)



PokerStars Zoom Hand #258129182726:  Hold'em No Limit (€0.01/€0.02) [ADM ID: M62C63044C87BABT] - 2025/10/15 1:10:54 CET [2025/10/14 19:10:54 ET]
Table 'Sirio' 6-max Seat #1 is the button
Seat 1: mashallahh (€7.97 in chips) 
Seat 2: Trezvenik93 (€3.12 in chips) 
Seat 3: ormaxam (€1.95 in chips) 
Seat 4: caduceus369 (€8.39 in chips) 
Seat 5: Warterror90 (€5.95 in chips) 
Trezvenik93: posts small blind €0.01
ormaxam: posts big blind €0.02
*** HOLE CARDS ***
Dealt to caduceus369 [4h 6h]
caduceus369: folds 
Warterror90: raises €0.04 to €0.06
mashallahh: folds 
Trezvenik93: folds 
ormaxam: folds 
Uncalled bet (€0.04) returned to Warterror90
Warterror90 collected €0.05 from pot
Warterror90: doesn't show hand 
*** SUMMARY ***
Total pot €0.05 | Rake €0 
Seat 1: mashallahh (button) folded before Flop (didn't bet)
Seat 2: Trezvenik93 (small blind) folded before Flop
Seat 3: ormaxam (big blind) folded before Flop
Seat 4: caduceus369 folded before Flop (didn't bet)
Seat 5: Warterror90 collected (€0.05)



PokerStars Zoom Hand #258129184585:  Hold'em No Limit (€0.01/€0.02) [ADM ID: M62C63044C87BABT] - 2025/10/15 1:11:05 CET [2025/10/14 19:11:05 ET]
Table 'Sirio' 6-max Seat #1 is the button
Seat 1: mashallahh (€4.91 in chips) 
Seat 2: franck19621962 (€1.17 in chips) 
Seat 3: caduceus369 (€8.38 in chips) 
Seat 4: miridersa (€1.23 in chips) 
Seat 5: ormaxam (€1.93 in chips) 
franck19621962: posts small blind €0.01
caduceus369: posts big blind €0.02
*** HOLE CARDS ***
Dealt to caduceus369 [4s 8d]
miridersa: folds 
ormaxam: folds 
mashallahh: raises €0.04 to €0.06
franck19621962: calls €0.05
caduceus369: folds 
*** FLOP *** [Jd 6h Kc]
franck19621962: checks 
mashallahh: bets €0.10
franck19621962: folds 
Uncalled bet (€0.10) returned to mashallahh
mashallahh collected €0.14 from pot
mashallahh: doesn't show hand 
*** SUMMARY ***
Total pot €0.14 | Rake €0 
Board [Jd 6h Kc]
Seat 1: mashallahh (button) collected (€0.14)
Seat 2: franck19621962 (small blind) folded on the Flop
Seat 3: caduceus369 (big blind) folded before Flop
Seat 4: miridersa folded before Flop (didn't bet)
Seat 5: ormaxam folded before Flop (didn't bet)



PokerStars Zoom Hand #258129183736:  Hold'em No Limit (€0.01/€0.02) [ADM ID: M62C63044C87BABT] - 2025/10/15 1:11:00 CET [2025/10/14 19:11:00 ET]
Table 'Sirio' 6-max Seat #1 is the button
Seat 1: father2008 (€2.01 in chips) 
Seat 2: caduceus369 (€8.39 in chips) 
Seat 3: CIKO71131 (€0.27 in chips) 
Seat 4: mashallahh (€4.91 in chips) 
Seat 5: Warterror90 (€3.76 in chips) 
caduceus369: posts small blind €0.01
CIKO71131: posts big blind €0.02
*** HOLE CARDS ***
Dealt to caduceus369 [8c Jc]
mashallahh: folds 
Warterror90: raises €0.04 to €0.06
father2008: calls €0.06
caduceus369: folds 
CIKO71131: calls €0.04
*** FLOP *** [5c 6h Ac]
CIKO71131: bets €0.02
Warterror90: raises €0.04 to €0.06
father2008: folds 
CIKO71131: calls €0.04
*** TURN *** [5c 6h Ac] [4s]
CIKO71131: checks 
Warterror90: bets €0.15
CIKO71131: calls €0.15 and is all-in
*** RIVER *** [5c 6h Ac 4s] [Tc]
*** SHOW DOWN ***
CIKO71131: shows [7s As] (a pair of Aces)
Warterror90: shows [7c 8d] (a straight, Four to Eight)
Warterror90 collected €0.58 from pot
*** SUMMARY ***
Total pot €0.61 | Rake €0.03 
Board [5c 6h Ac 4s Tc]
Seat 1: father2008 (button) folded on the Flop
Seat 2: caduceus369 (small blind) folded before Flop
Seat 3: CIKO71131 (big blind) showed [7s As] and lost with a pair of Aces
Seat 4: mashallahh folded before Flop (didn't bet)
Seat 5: Warterror90 showed [7c 8d] and won (€0.58) with a straight, Four to Eight



PokerStars Zoom Hand #258129187821:  Hold'em No Limit (€0.01/€0.02) [ADM ID: M62C63044C87BABT] - 2025/10/15 1:11:24 CET [2025/10/14 19:11:24 ET]
Table 'Sirio' 6-max Seat #1 is the button
Seat 1: caduceus369 (€8.36 in chips) 
Seat 2: ilteatro131 (€1.50 in chips) 
Seat 3: Begimon (€11.09 in chips) 
Seat 4: EasyToRule (€2.21 in chips) 
Seat 5: QUEEN-KING-QQKK (€3.07 in chips) 
ilteatro131: posts small blind €0.01
Begimon: posts big blind €0.02
*** HOLE CARDS ***
Dealt to caduceus369 [6h Ah]
EasyToRule: folds 
QUEEN-KING-QQKK: raises €0.05 to €0.07
caduceus369: calls €0.07
ilteatro131: calls €0.06
Begimon: calls €0.05
*** FLOP *** [8s Jh Jc]
ilteatro131: checks 
Begimon: checks 
QUEEN-KING-QQKK: checks 
caduceus369: checks 
*** TURN *** [8s Jh Jc] [As]
ilteatro131: bets €0.02
Begimon: calls €0.02
QUEEN-KING-QQKK: calls €0.02
caduceus369: calls €0.02
*** RIVER *** [8s Jh Jc As] [Jd]
ilteatro131: checks 
Begimon: bets €11 and is all-in
QUEEN-KING-QQKK: folds 
caduceus369: folds 
ilteatro131: folds 
Uncalled bet (€11) returned to Begimon
Begimon collected €0.35 from pot
Begimon: doesn't show hand 
*** SUMMARY ***
Total pot €0.36 | Rake €0.01 
Board [8s Jh Jc As Jd]
Seat 1: caduceus369 (button) folded on the River
Seat 2: ilteatro131 (small blind) folded on the River
Seat 3: Begimon (big blind) collected (€0.35)
Seat 4: EasyToRule folded before Flop (didn't bet)
Seat 5: QUEEN-KING-QQKK folded on the River



PokerStars Zoom Hand #258129196925:  Hold'em No Limit (€0.01/€0.02) [ADM ID: M62C63044C87BABT] - 2025/10/15 1:12:17 CET [2025/10/14 19:12:17 ET]
Table 'Sirio' 6-max Seat #1 is the button
Seat 1: Macantoni (€0.85 in chips) 
Seat 2: father2008 (€2 in chips) 
Seat 3: uziu47 (€1.72 in chips) 
Seat 4: dandoshats (€3.89 in chips) 
Seat 5: Warterror90 (€4.05 in chips) 
Seat 6: caduceus369 (€8.27 in chips) 
father2008: posts small blind €0.01
uziu47: posts big blind €0.02
*** HOLE CARDS ***
Dealt to caduceus369 [As 2d]
dandoshats: raises €0.02 to €0.04
Warterror90: folds 
caduceus369: folds 
Macantoni: calls €0.04
father2008: folds 
uziu47: calls €0.02
*** FLOP *** [5c 9c 9d]
uziu47: bets €0.04
dandoshats: folds 
Macantoni: folds 
Uncalled bet (€0.04) returned to uziu47
uziu47 collected €0.13 from pot
uziu47: doesn't show hand 
*** SUMMARY ***
Total pot €0.13 | Rake €0 
Board [5c 9c 9d]
Seat 1: Macantoni (button) folded on the Flop
Seat 2: father2008 (small blind) folded before Flop
Seat 3: uziu47 (big blind) collected (€0.13)
Seat 4: dandoshats folded on the Flop
Seat 5: Warterror90 folded before Flop (didn't bet)
Seat 6: caduceus369 folded before Flop (didn't bet)



PokerStars Zoom Hand #258129198922:  Hold'em No Limit (€0.01/€0.02) [ADM ID: M62C63044C87BABT] - 2025/10/15 1:12:29 CET [2025/10/14 19:12:29 ET]
Table 'Sirio' 6-max Seat #1 is the button
Seat 1: mashallahh (€8.35 in chips) 
Seat 2: CIKO71131 (€0.90 in chips) 
Seat 3: father2008 (€2.40 in chips) 
Seat 4: caduceus369 (€8.27 in chips) 
Seat 5: EasyToRule (€2.20 in chips) 
Seat 6: Poetto65 (€0.61 in chips) 
CIKO71131: posts small blind €0.01
father2008: posts big blind €0.02
*** HOLE CARDS ***
Dealt to caduceus369 [2h Ah]
caduceus369: folds 
EasyToRule: folds 
Poetto65: folds 
mashallahh: raises €0.04 to €0.06
CIKO71131: folds 
father2008: folds 
Uncalled bet (€0.04) returned to mashallahh
mashallahh collected €0.05 from pot
mashallahh: doesn't show hand 
*** SUMMARY ***
Total pot €0.05 | Rake €0 
Seat 1: mashallahh (button) collected (€0.05)
Seat 2: CIKO71131 (small blind) folded before Flop
Seat 3: father2008 (big blind) folded before Flop
Seat 4: caduceus369 folded before Flop (didn't bet)
Seat 5: EasyToRule folded before Flop (didn't bet)
Seat 6: Poetto65 folded before Flop (didn't bet)



PokerStars Zoom Hand #258129200918:  Hold'em No Limit (€0.01/€0.02) [ADM ID: M62C63044C87BABT] - 2025/10/15 1:12:42 CET [2025/10/14 19:12:42 ET]
Table 'Sirio' 6-max Seat #1 is the button
Seat 1: caduceus369 (€8.27 in chips) 
Seat 2: QUEEN-KING-QQKK (€2.92 in chips) 
Seat 3: dandoshats (€3.85 in chips) 
Seat 4: Warterror90 (€7.30 in chips) 
Seat 5: mashallahh (€2.87 in chips) 
Seat 6: franck19621962 (€1.17 in chips) 
QUEEN-KING-QQKK: posts small blind €0.01
dandoshats: posts big blind €0.02
*** HOLE CARDS ***
Dealt to caduceus369 [Tc Ad]
Warterror90: folds 
mashallahh: folds 
franck19621962: calls €0.02
caduceus369: raises €0.06 to €0.08
QUEEN-KING-QQKK: folds 
dandoshats: folds 
franck19621962: folds 
Uncalled bet (€0.06) returned to caduceus369
caduceus369 collected €0.07 from pot
caduceus369: doesn't show hand 
*** SUMMARY ***
Total pot €0.07 | Rake €0 
Seat 1: caduceus369 (button) collected (€0.07)
Seat 2: QUEEN-KING-QQKK (small blind) folded before Flop
Seat 3: dandoshats (big blind) folded before Flop
Seat 4: Warterror90 folded before Flop (didn't bet)
Seat 5: mashallahh folded before Flop (didn't bet)
Seat 6: franck19621962 folded before Flop



PokerStars Zoom Hand #258129199564:  Hold'em No Limit (€0.01/€0.02) [ADM ID: M62C63044C87BABT] - 2025/10/15 1:12:33 CET [2025/10/14 19:12:33 ET]
Table 'Sirio' 6-max Seat #1 is the button
Seat 1: EasyToRule (€2.20 in chips) 
Seat 2: BiscottinoXXL (€2.03 in chips) 
Seat 3: father2008 (€2 in chips) 
Seat 4: caduceus369 (€8.27 in chips) 
Seat 5: franck19621962 (€1.17 in chips) 
Seat 6: mashallahh (€2.87 in chips) 
BiscottinoXXL: posts small blind €0.01
father2008: posts big blind €0.02
*** HOLE CARDS ***
Dealt to caduceus369 [Kh Tc]
caduceus369: folds 
franck19621962: folds 
mashallahh: folds 
EasyToRule: raises €0.03 to €0.05
BiscottinoXXL: folds 
father2008: folds 
Uncalled bet (€0.03) returned to EasyToRule
EasyToRule collected €0.05 from pot
EasyToRule: doesn't show hand 
*** SUMMARY ***
Total pot €0.05 | Rake €0 
Seat 1: EasyToRule (button) collected (€0.05)
Seat 2: BiscottinoXXL (small blind) folded before Flop
Seat 3: father2008 (big blind) folded before Flop
Seat 4: caduceus369 folded before Flop (didn't bet)
Seat 5: franck19621962 folded before Flop (didn't bet)
Seat 6: mashallahh folded before Flop (didn't bet)



PokerStars Zoom Hand #258129198129:  Hold'em No Limit (€0.01/€0.02) [ADM ID: M62C63044C87BABT] - 2025/10/15 1:12:24 CET [2025/10/14 19:12:24 ET]
Table 'Sirio' 6-max Seat #1 is the button
Seat 1: Warterror90 (€4.05 in chips) 
Seat 2: mashallahh (€2.88 in chips) 
Seat 3: bartolo608 (€2.15 in chips) 
Seat 4: meteco79 (€0.79 in chips) 
Seat 5: caduceus369 (€8.27 in chips) 
Seat 6: Begimon (€11.35 in chips) 
mashallahh: posts small blind €0.01
bartolo608: posts big blind €0.02
*** HOLE CARDS ***
Dealt to caduceus369 [Qs 4s]
meteco79: calls €0.02
caduceus369: folds 
Begimon: calls €0.02
Warterror90: raises €0.04 to €0.06
mashallahh: folds 
bartolo608: folds 
meteco79: calls €0.04
Begimon: calls €0.04
*** FLOP *** [5d 9c 4d]
meteco79: bets €0.73 and is all-in
Begimon: folds 
Warterror90: folds 
Uncalled bet (€0.73) returned to meteco79
meteco79 collected €0.20 from pot
meteco79: doesn't show hand 
*** SUMMARY ***
Total pot €0.21 | Rake €0.01 
Board [5d 9c 4d]
Seat 1: Warterror90 (button) folded on the Flop
Seat 2: mashallahh (small blind) folded before Flop
Seat 3: bartolo608 (big blind) folded before Flop
Seat 4: meteco79 collected (€0.20)
Seat 5: caduceus369 folded before Flop (didn't bet)
Seat 6: Begimon folded on the Flop



PokerStars Zoom Hand #258129206594:  Hold'em No Limit (€0.01/€0.02) [ADM ID: M62C63044C87BABT] - 2025/10/15 1:13:16 CET [2025/10/14 19:13:16 ET]
Table 'Sirio' 6-max Seat #1 is the button
Seat 1: EasyToRule (€2.23 in chips) 
Seat 2: bartolo608 (€2.01 in chips) 
Seat 3: caduceus369 (€8.31 in chips) 
Seat 4: father2008 (€2 in chips) 
Seat 5: QUEEN-KING-QQKK (€2.88 in chips) 
Seat 6: dandoshats (€3.82 in chips) 
bartolo608: posts small blind €0.01
caduceus369: posts big blind €0.02
*** HOLE CARDS ***
Dealt to caduceus369 [Qs 5s]
father2008: folds 
QUEEN-KING-QQKK: calls €0.02
dandoshats: raises €0.08 to €0.10
EasyToRule: folds 
bartolo608: folds 
caduceus369: folds 
QUEEN-KING-QQKK: calls €0.08
*** FLOP *** [6h Qc 9c]
QUEEN-KING-QQKK: checks 
dandoshats: checks 
*** TURN *** [6h Qc 9c] [Ah]
QUEEN-KING-QQKK: checks 
dandoshats: bets €0.13
QUEEN-KING-QQKK: folds 
Uncalled bet (€0.13) returned to dandoshats
dandoshats collected €0.22 from pot
dandoshats: doesn't show hand 
*** SUMMARY ***
Total pot €0.23 | Rake €0.01 
Board [6h Qc 9c Ah]
Seat 1: EasyToRule (button) folded before Flop (didn't bet)
Seat 2: bartolo608 (small blind) folded before Flop
Seat 3: caduceus369 (big blind) folded before Flop
Seat 4: father2008 folded before Flop (didn't bet)
Seat 5: QUEEN-KING-QQKK folded on the Turn
Seat 6: dandoshats collected (€0.22)



PokerStars Zoom Hand #258129210935:  Hold'em No Limit (€0.01/€0.02) [ADM ID: M62C63044C87BABT] - 2025/10/15 1:13:41 CET [2025/10/14 19:13:41 ET]
Table 'Sirio' 6-max Seat #1 is the button
Seat 1: QUEEN-KING-QQKK (€2.78 in chips) 
Seat 2: Temait77728 (€1.85 in chips) 
Seat 3: EasyToRule (€2.22 in chips) 
Seat 4: caduceus369 (€8.29 in chips) 
Seat 5: ADRIAN0_MEIS (€6.27 in chips) 
Temait77728: posts small blind €0.01
EasyToRule: posts big blind €0.02
*** HOLE CARDS ***
Dealt to caduceus369 [Ks 8d]
caduceus369: folds 
ADRIAN0_MEIS: folds 
QUEEN-KING-QQKK: raises €0.05 to €0.07
Temait77728: folds 
EasyToRule: folds 
Uncalled bet (€0.05) returned to QUEEN-KING-QQKK
QUEEN-KING-QQKK collected €0.05 from pot
QUEEN-KING-QQKK: doesn't show hand 
*** SUMMARY ***
Total pot €0.05 | Rake €0 
Seat 1: QUEEN-KING-QQKK (button) collected (€0.05)
Seat 2: Temait77728 (small blind) folded before Flop
Seat 3: EasyToRule (big blind) folded before Flop
Seat 4: caduceus369 folded before Flop (didn't bet)
Seat 5: ADRIAN0_MEIS folded before Flop (didn't bet)



PokerStars Zoom Hand #258129212068:  Hold'em No Limit (€0.01/€0.02) [ADM ID: M62C63044C87BABT] - 2025/10/15 1:13:48 CET [2025/10/14 19:13:48 ET]
Table 'Sirio' 6-max Seat #1 is the button
Seat 1: caduceus369 (€8.29 in chips) 
Seat 2: franck19621962 (€1.07 in chips) 
Seat 3: xebarpz4400 (€0.80 in chips) 
Seat 4: mashallahh (€2.84 in chips) 
Seat 5: dandoshats (€1.78 in chips) 
Seat 6: ADRIAN0_MEIS (€6.27 in chips) 
franck19621962: posts small blind €0.01
xebarpz4400: posts big blind €0.02
*** HOLE CARDS ***
Dealt to caduceus369 [4d Js]
mashallahh: folds 
dandoshats: calls €0.02
ADRIAN0_MEIS: folds 
caduceus369: folds 
franck19621962: folds 
xebarpz4400: raises €0.02 to €0.04
dandoshats: raises €1.74 to €1.78 and is all-in
xebarpz4400: folds 
Uncalled bet (€1.74) returned to dandoshats
dandoshats collected €0.09 from pot
dandoshats: doesn't show hand 
*** SUMMARY ***
Total pot €0.09 | Rake €0 
Seat 1: caduceus369 (button) folded before Flop (didn't bet)
Seat 2: franck19621962 (small blind) folded before Flop
Seat 3: xebarpz4400 (big blind) folded before Flop
Seat 4: mashallahh folded before Flop (didn't bet)
Seat 5: dandoshats collected (€0.09)
Seat 6: ADRIAN0_MEIS folded before Flop (didn't bet)



PokerStars Zoom Hand #258129204089:  Hold'em No Limit (€0.01/€0.02) [ADM ID: M62C63044C87BABT] - 2025/10/15 1:13:01 CET [2025/10/14 19:13:01 ET]
Table 'Sirio' 6-max Seat #1 is the button
Seat 1: Poetto65 (€0.64 in chips) 
Seat 2: caduceus369 (€8.32 in chips) 
Seat 3: QUEEN-KING-QQKK (€1.94 in chips) 
Seat 4: franck19621962 (€1.15 in chips) 
Seat 5: mashallahh (€5.19 in chips) 
Seat 6: Warterror90 (€3.99 in chips) 
caduceus369: posts small blind €0.01
QUEEN-KING-QQKK: posts big blind €0.02
*** HOLE CARDS ***
Dealt to caduceus369 [8c 3h]
franck19621962: calls €0.02
mashallahh: folds 
Warterror90: raises €0.04 to €0.06
Poetto65: calls €0.06
caduceus369: folds 
QUEEN-KING-QQKK: calls €0.04
franck19621962: calls €0.04
*** FLOP *** [Js Th 2s]
QUEEN-KING-QQKK: checks 
franck19621962: checks 
Warterror90: bets €0.08
Poetto65: calls €0.08
QUEEN-KING-QQKK: folds 
franck19621962: folds 
*** TURN *** [Js Th 2s] [Qh]
Warterror90: bets €0.14
Poetto65: raises €0.36 to €0.50 and is all-in
Warterror90: calls €0.36
*** RIVER *** [Js Th 2s Qh] [2h]
*** SHOW DOWN ***
Warterror90: shows [Tc Td] (a full house, Tens full of Deuces)
Poetto65: shows [Qc As] (two pair, Queens and Deuces)
Warterror90 collected €1.34 from pot
*** SUMMARY ***
Total pot €1.41 | Rake €0.07 
Board [Js Th 2s Qh 2h]
Seat 1: Poetto65 (button) showed [Qc As] and lost with two pair, Queens and Deuces
Seat 2: caduceus369 (small blind) folded before Flop
Seat 3: QUEEN-KING-QQKK (big blind) folded on the Flop
Seat 4: franck19621962 folded on the Flop
Seat 5: mashallahh folded before Flop (didn't bet)
Seat 6: Warterror90 showed [Tc Td] and won (€1.34) with a full house, Tens full of Deuces



PokerStars Zoom Hand #258129209926:  Hold'em No Limit (€0.01/€0.02) [ADM ID: M62C63044C87BABT] - 2025/10/15 1:13:35 CET [2025/10/14 19:13:35 ET]
Table 'Sirio' 6-max Seat #1 is the button
Seat 1: father2008 (€2.45 in chips) 
Seat 2: QUEEN-KING-QQKK (€1.88 in chips) 
Seat 3: franck19621962 (€1.09 in chips) 
Seat 4: uziu47 (€1.75 in chips) 
Seat 5: caduceus369 (€8.29 in chips) 
QUEEN-KING-QQKK: posts small blind €0.01
franck19621962: posts big blind €0.02
*** HOLE CARDS ***
Dealt to caduceus369 [6s 2d]
uziu47: calls €0.02
caduceus369: folds 
father2008: raises €0.07 to €0.09
QUEEN-KING-QQKK: calls €0.08
franck19621962: folds 
uziu47: calls €0.07
*** FLOP *** [3c Th Kd]
QUEEN-KING-QQKK: checks 
uziu47: checks 
father2008: checks 
*** TURN *** [3c Th Kd] [7c]
QUEEN-KING-QQKK: checks 
uziu47: checks 
father2008: checks 
*** RIVER *** [3c Th Kd 7c] [Qh]
QUEEN-KING-QQKK: bets €0.28
uziu47: calls €0.28
father2008: raises €2.08 to €2.36 and is all-in
QUEEN-KING-QQKK: folds 
uziu47: folds 
Uncalled bet (€2.08) returned to father2008
father2008 collected €1.07 from pot
father2008: doesn't show hand 
*** SUMMARY ***
Total pot €1.13 | Rake €0.06 
Board [3c Th Kd 7c Qh]
Seat 1: father2008 (button) collected (€1.07)
Seat 2: QUEEN-KING-QQKK (small blind) folded on the River
Seat 3: franck19621962 (big blind) folded before Flop
Seat 4: uziu47 folded on the River
Seat 5: caduceus369 folded before Flop (didn't bet)



PokerStars Zoom Hand #258129212818:  Hold'em No Limit (€0.01/€0.02) [ADM ID: M62C63044C87BABT] - 2025/10/15 1:13:53 CET [2025/10/14 19:13:53 ET]
Table 'Sirio' 6-max Seat #1 is the button
Seat 1: CIKO71131 (€0.76 in chips) 
Seat 2: caduceus369 (€8.29 in chips) 
Seat 3: bartolo608 (€1.90 in chips) 
Seat 4: franck19621962 (€1.06 in chips) 
Seat 5: ilteatro131 (€1.36 in chips) 
Seat 6: mashallahh (€7.92 in chips) 
caduceus369: posts small blind €0.01
bartolo608: posts big blind €0.02
*** HOLE CARDS ***
Dealt to caduceus369 [Ah Qs]
franck19621962: folds 
ilteatro131: folds 
mashallahh: folds 
CIKO71131: calls €0.02
caduceus369: raises €0.06 to €0.08
bartolo608: calls €0.06
CIKO71131: calls €0.06
*** FLOP *** [7h 4d Qh]
caduceus369: checks 
bartolo608: checks 
CIKO71131: checks 
*** TURN *** [7h 4d Qh] [2d]
caduceus369: bets €0.02
bartolo608: calls €0.02
CIKO71131: raises €0.29 to €0.31
caduceus369: calls €0.29
bartolo608: folds 
*** RIVER *** [7h 4d Qh 2d] [Jc]
caduceus369: checks 
CIKO71131: bets €0.37 and is all-in
caduceus369: calls €0.37
*** SHOW DOWN ***
CIKO71131: shows [7c 7s] (three of a kind, Sevens)
caduceus369: shows [Ah Qs] (a pair of Queens)
CIKO71131 collected €1.54 from pot
*** SUMMARY ***
Total pot €1.62 | Rake €0.08 
Board [7h 4d Qh 2d Jc]
Seat 1: CIKO71131 (button) showed [7c 7s] and won (€1.54) with three of a kind, Sevens
Seat 2: caduceus369 (small blind) showed [Ah Qs] and lost with a pair of Queens
Seat 3: bartolo608 (big blind) folded on the Turn
Seat 4: franck19621962 folded before Flop (didn't bet)
Seat 5: ilteatro131 folded before Flop (didn't bet)
Seat 6: mashallahh folded before Flop (didn't bet)



PokerStars Zoom Hand #258129222879:  Hold'em No Limit (€0.01/€0.02) [ADM ID: M62C63044C87BABT] - 2025/10/15 1:14:53 CET [2025/10/14 19:14:53 ET]
Table 'Sirio' 6-max Seat #1 is the button
Seat 1: Macantoni (€0.66 in chips) 
Seat 2: mashallahh (€5.20 in chips) 
Seat 3: EasyToRule (€2.12 in chips) 
Seat 4: ADRIAN0_MEIS (€6.24 in chips) 
Seat 5: Trezvenik93 (€2 in chips) 
Seat 6: caduceus369 (€7.53 in chips) 
mashallahh: posts small blind €0.01
EasyToRule: posts big blind €0.02
*** HOLE CARDS ***
Dealt to caduceus369 [9c Ah]
ADRIAN0_MEIS: folds 
Trezvenik93: folds 
caduceus369: folds 
Macantoni: folds 
mashallahh: folds 
Uncalled bet (€0.01) returned to EasyToRule
EasyToRule collected €0.02 from pot
EasyToRule: doesn't show hand 
*** SUMMARY ***
Total pot €0.02 | Rake €0 
Seat 1: Macantoni (button) folded before Flop (didn't bet)
Seat 2: mashallahh (small blind) folded before Flop
Seat 3: EasyToRule (big blind) collected (€0.02)
Seat 4: ADRIAN0_MEIS folded before Flop (didn't bet)
Seat 5: Trezvenik93 folded before Flop (didn't bet)
Seat 6: caduceus369 folded before Flop (didn't bet)



PokerStars Zoom Hand #258129224290:  Hold'em No Limit (€0.01/€0.02) [ADM ID: M62C63044C87BABT] - 2025/10/15 1:15:01 CET [2025/10/14 19:15:01 ET]
Table 'Sirio' 6-max Seat #1 is the button
Seat 1: mashallahh (€7.89 in chips) 
Seat 2: CIKO71131 (€0.76 in chips) 
Seat 3: caduceus369 (€7.53 in chips) 
Seat 4: dandoshats (€3.66 in chips) 
Seat 5: father2008 (€2.05 in chips) 
Seat 6: uziu47 (€1.36 in chips) 
CIKO71131: posts small blind €0.01
caduceus369: posts big blind €0.02
*** HOLE CARDS ***
Dealt to caduceus369 [Qc 7h]
dandoshats: raises €0.04 to €0.06
father2008: folds 
uziu47: folds 
mashallahh: folds 
CIKO71131: calls €0.05
caduceus369: folds 
*** FLOP *** [6c 4c 5h]
CIKO71131: checks 
dandoshats: bets €0.14
CIKO71131: folds 
Uncalled bet (€0.14) returned to dandoshats
dandoshats collected €0.14 from pot
dandoshats: doesn't show hand 
*** SUMMARY ***
Total pot €0.14 | Rake €0 
Board [6c 4c 5h]
Seat 1: mashallahh (button) folded before Flop (didn't bet)
Seat 2: CIKO71131 (small blind) folded on the Flop
Seat 3: caduceus369 (big blind) folded before Flop
Seat 4: dandoshats collected (€0.14)
Seat 5: father2008 folded before Flop (didn't bet)
Seat 6: uziu47 folded before Flop (didn't bet)



PokerStars Zoom Hand #258129225995:  Hold'em No Limit (€0.01/€0.02) [ADM ID: M62C63044C87BABT] - 2025/10/15 1:15:11 CET [2025/10/14 19:15:11 ET]
Table 'Sirio' 6-max Seat #1 is the button
Seat 1: Temait77728 (€1.84 in chips) 
Seat 2: mashallahh (€7.89 in chips) 
Seat 3: Macantoni (€0.66 in chips) 
Seat 4: bartolo608 (€1.82 in chips) 
Seat 5: caduceus369 (€7.51 in chips) 
Seat 6: Warterror90 (€6.79 in chips) 
mashallahh: posts small blind €0.01
Macantoni: posts big blind €0.02
*** HOLE CARDS ***
Dealt to caduceus369 [Jh Qc]
bartolo608: folds 
caduceus369: raises €0.04 to €0.06
Warterror90: raises €0.12 to €0.18
Temait77728: folds 
mashallahh: folds 
Macantoni: folds 
caduceus369: folds 
Uncalled bet (€0.12) returned to Warterror90
Warterror90 collected €0.15 from pot
Warterror90: doesn't show hand 
*** SUMMARY ***
Total pot €0.15 | Rake €0 
Seat 1: Temait77728 (button) folded before Flop (didn't bet)
Seat 2: mashallahh (small blind) folded before Flop
Seat 3: Macantoni (big blind) folded before Flop
Seat 4: bartolo608 folded before Flop (didn't bet)
Seat 5: caduceus369 folded before Flop
Seat 6: Warterror90 collected (€0.15)



PokerStars Zoom Hand #258129228188:  Hold'em No Limit (€0.01/€0.02) [ADM ID: M62C63044C87BABT] - 2025/10/15 1:15:24 CET [2025/10/14 19:15:24 ET]
Table 'Sirio' 6-max Seat #1 is the button
Seat 1: mashallahh (€7.88 in chips) 
Seat 2: EasyToRule (€2.05 in chips) 
Seat 3: BiscottinoXXL (€2.03 in chips) 
Seat 4: QUEEN-KING-QQKK (€2.69 in chips) 
Seat 5: Trezvenik93 (€3.76 in chips) 
Seat 6: caduceus369 (€7.45 in chips) 
EasyToRule: posts small blind €0.01
BiscottinoXXL: posts big blind €0.02
*** HOLE CARDS ***
Dealt to caduceus369 [6h 3d]
QUEEN-KING-QQKK: raises €0.06 to €0.08
Trezvenik93: folds 
caduceus369: folds 
mashallahh: folds 
EasyToRule: folds 
BiscottinoXXL: folds 
Uncalled bet (€0.06) returned to QUEEN-KING-QQKK
QUEEN-KING-QQKK collected €0.05 from pot
QUEEN-KING-QQKK: doesn't show hand 
*** SUMMARY ***
Total pot €0.05 | Rake €0 
Seat 1: mashallahh (button) folded before Flop (didn't bet)
Seat 2: EasyToRule (small blind) folded before Flop
Seat 3: BiscottinoXXL (big blind) folded before Flop
Seat 4: QUEEN-KING-QQKK collected (€0.05)
Seat 5: Trezvenik93 folded before Flop (didn't bet)
Seat 6: caduceus369 folded before Flop (didn't bet)



PokerStars Zoom Hand #258129231145:  Hold'em No Limit (€0.01/€0.02) [ADM ID: M62C63044C87BABT] - 2025/10/15 1:15:41 CET [2025/10/14 19:15:41 ET]
Table 'Sirio' 6-max Seat #1 is the button
Seat 1: dandoshats (€2.19 in chips) 
Seat 2: BiscottinoXXL (€2.01 in chips) 
Seat 3: ADRIAN0_MEIS (€6.32 in chips) 
Seat 4: Temait77728 (€1.82 in chips) 
Seat 5: caduceus369 (€7.45 in chips) 
Seat 6: QUEEN-KING-QQKK (€2.72 in chips) 
BiscottinoXXL: posts small blind €0.01
ADRIAN0_MEIS: posts big blind €0.02
*** HOLE CARDS ***
Dealt to caduceus369 [3c 7d]
Temait77728: raises €0.04 to €0.06
caduceus369: folds 
QUEEN-KING-QQKK: folds 
dandoshats: folds 
BiscottinoXXL: folds 
ADRIAN0_MEIS: folds 
Uncalled bet (€0.04) returned to Temait77728
Temait77728 collected €0.05 from pot
Temait77728: doesn't show hand 
*** SUMMARY ***
Total pot €0.05 | Rake €0 
Seat 1: dandoshats (button) folded before Flop (didn't bet)
Seat 2: BiscottinoXXL (small blind) folded before Flop
Seat 3: ADRIAN0_MEIS (big blind) folded before Flop
Seat 4: Temait77728 collected (€0.05)
Seat 5: caduceus369 folded before Flop (didn't bet)
Seat 6: QUEEN-KING-QQKK folded before Flop (didn't bet)



PokerStars Zoom Hand #258129229907:  Hold'em No Limit (€0.01/€0.02) [ADM ID: M62C63044C87BABT] - 2025/10/15 1:15:34 CET [2025/10/14 19:15:34 ET]
Table 'Sirio' 6-max Seat #1 is the button
Seat 1: uziu47 (€1.34 in chips) 
Seat 2: dandoshats (€3.72 in chips) 
Seat 3: EasyToRule (€2.04 in chips) 
Seat 4: caduceus369 (€7.45 in chips) 
Seat 5: meteco79 (€1.14 in chips) 
Seat 6: mashallahh (€8.61 in chips) 
dandoshats: posts small blind €0.01
EasyToRule: posts big blind €0.02
*** HOLE CARDS ***
Dealt to caduceus369 [2h 5s]
caduceus369: folds 
meteco79: calls €0.02
mashallahh: raises €0.06 to €0.08
uziu47: folds 
dandoshats: raises €0.18 to €0.26
EasyToRule: folds 
meteco79: calls €0.24
mashallahh: calls €0.18
*** FLOP *** [Jd 8c 3h]
dandoshats: checks 
meteco79: bets €0.88 and is all-in
mashallahh: folds 
dandoshats: calls €0.88
*** TURN *** [Jd 8c 3h] [6d]
*** RIVER *** [Jd 8c 3h 6d] [4d]
*** SHOW DOWN ***
dandoshats: shows [Qh Ah] (high card Ace)
meteco79: shows [Ks Kd] (a pair of Kings)
meteco79 collected €2.42 from pot
*** SUMMARY ***
Total pot €2.56 | Rake €0.14 
Board [Jd 8c 3h 6d 4d]
Seat 1: uziu47 (button) folded before Flop (didn't bet)
Seat 2: dandoshats (small blind) showed [Qh Ah] and lost with high card Ace
Seat 3: EasyToRule (big blind) folded before Flop
Seat 4: caduceus369 folded before Flop (didn't bet)
Seat 5: meteco79 showed [Ks Kd] and won (€2.42) with a pair of Kings
Seat 6: mashallahh folded on the Flop



PokerStars Zoom Hand #258129232313:  Hold'em No Limit (€0.01/€0.02) [ADM ID: M62C63044C87BABT] - 2025/10/15 1:15:48 CET [2025/10/14 19:15:48 ET]
Table 'Sirio' 6-max Seat #1 is the button
Seat 1: QUEEN-KING-QQKK (€2.72 in chips) 
Seat 2: caduceus369 (€7.45 in chips) 
Seat 3: uziu47 (€1.34 in chips) 
Seat 4: Warterror90 (€6.87 in chips) 
Seat 5: father2008 (€2.88 in chips) 
Seat 6: BiscottinoXXL (€3.90 in chips) 
caduceus369: posts small blind €0.01
uziu47: posts big blind €0.02
*** HOLE CARDS ***
Dealt to caduceus369 [8s 4h]
Warterror90: folds 
father2008: raises €0.04 to €0.06
BiscottinoXXL: folds 
QUEEN-KING-QQKK: folds 
caduceus369: folds 
uziu47: calls €0.04
*** FLOP *** [9d Jh Kc]
uziu47: checks 
father2008: checks 
*** TURN *** [9d Jh Kc] [Ah]
uziu47: checks 
father2008: checks 
*** RIVER *** [9d Jh Kc Ah] [5c]
uziu47: checks 
father2008: checks 
*** SHOW DOWN ***
uziu47: shows [Qh 9c] (a pair of Nines)
father2008: mucks hand 
uziu47 collected €0.13 from pot
*** SUMMARY ***
Total pot €0.13 | Rake €0 
Board [9d Jh Kc Ah 5c]
Seat 1: QUEEN-KING-QQKK (button) folded before Flop (didn't bet)
Seat 2: caduceus369 (small blind) folded before Flop
Seat 3: uziu47 (big blind) showed [Qh 9c] and won (€0.13) with a pair of Nines
Seat 4: Warterror90 folded before Flop (didn't bet)
Seat 5: father2008 mucked [Ts 9s]
Seat 6: BiscottinoXXL folded before Flop (didn't bet)



PokerStars Zoom Hand #258129234328:  Hold'em No Limit (€0.01/€0.02) [ADM ID: M62C63044C87BABT] - 2025/10/15 1:16:00 CET [2025/10/14 19:16:00 ET]
Table 'Sirio' 6-max Seat #1 is the button
Seat 1: caduceus369 (€7.44 in chips) 
Seat 2: bartolo608 (€1.78 in chips) 
Seat 3: Warterror90 (€6.87 in chips) 
Seat 4: BiscottinoXXL (€2 in chips) 
Seat 5: franck19621962 (€0.87 in chips) 
Seat 6: EasyToRule (€2.02 in chips) 
bartolo608: posts small blind €0.01
Warterror90: posts big blind €0.02
*** HOLE CARDS ***
Dealt to caduceus369 [9h 2h]
BiscottinoXXL: folds 
franck19621962: folds 
EasyToRule: raises €0.03 to €0.05
caduceus369: folds 
bartolo608: calls €0.04
Warterror90: folds 
*** FLOP *** [9d Qc 8h]
bartolo608: checks 
EasyToRule: bets €0.03
bartolo608: calls €0.03
*** TURN *** [9d Qc 8h] [3s]
bartolo608: bets €0.06
EasyToRule: folds 
Uncalled bet (€0.06) returned to bartolo608
bartolo608 collected €0.18 from pot
bartolo608: doesn't show hand 
*** SUMMARY ***
Total pot €0.18 | Rake €0 
Board [9d Qc 8h 3s]
Seat 1: caduceus369 (button) folded before Flop (didn't bet)
Seat 2: bartolo608 (small blind) collected (€0.18)
Seat 3: Warterror90 (big blind) folded before Flop
Seat 4: BiscottinoXXL folded before Flop (didn't bet)
Seat 5: franck19621962 folded before Flop (didn't bet)
Seat 6: EasyToRule folded on the Turn



PokerStars Zoom Hand #258129236354:  Hold'em No Limit (€0.01/€0.02) [ADM ID: M62C63044C87BABT] - 2025/10/15 1:16:12 CET [2025/10/14 19:16:12 ET]
Table 'Sirio' 6-max Seat #1 is the button
Seat 1: mashallahh (€8.35 in chips) 
Seat 2: ilteatro131 (€1.19 in chips) 
Seat 3: caduceus369 (€7.44 in chips) 
Seat 4: QUEEN-KING-QQKK (€2.70 in chips) 
Seat 5: Warterror90 (€6.85 in chips) 
Seat 6: BiscottinoXXL (€2 in chips) 
ilteatro131: posts small blind €0.01
caduceus369: posts big blind €0.02
*** HOLE CARDS ***
Dealt to caduceus369 [Kh 9h]
QUEEN-KING-QQKK: raises €0.02 to €0.04
Warterror90: folds 
BiscottinoXXL: calls €0.04
mashallahh: calls €0.04
ilteatro131: calls €0.03
caduceus369: calls €0.02
*** FLOP *** [Jc Jh 5h]
ilteatro131: checks 
caduceus369: checks 
QUEEN-KING-QQKK: bets €0.10
BiscottinoXXL: folds 
mashallahh: folds 
ilteatro131: folds 
caduceus369: folds 
Uncalled bet (€0.10) returned to QUEEN-KING-QQKK
QUEEN-KING-QQKK collected €0.19 from pot
QUEEN-KING-QQKK: doesn't show hand 
*** SUMMARY ***
Total pot €0.20 | Rake €0.01 
Board [Jc Jh 5h]
Seat 1: mashallahh (button) folded on the Flop
Seat 2: ilteatro131 (small blind) folded on the Flop
Seat 3: caduceus369 (big blind) folded on the Flop
Seat 4: QUEEN-KING-QQKK collected (€0.19)
Seat 5: Warterror90 folded before Flop (didn't bet)
Seat 6: BiscottinoXXL folded on the Flop



PokerStars Zoom Hand #258129246017:  Hold'em No Limit (€0.01/€0.02) [ADM ID: M62C63044C87BABT] - 2025/10/15 1:17:10 CET [2025/10/14 19:17:10 ET]
Table 'Sirio' 6-max Seat #1 is the button
Seat 1: mashallahh (€7.63 in chips) 
Seat 2: EasyToRule (€2.03 in chips) 
Seat 3: franck19621962 (€1.04 in chips) 
Seat 4: caduceus369 (€7.40 in chips) 
Seat 5: father2008 (€2 in chips) 
Seat 6: CIKO71131 (€0.80 in chips) 
EasyToRule: posts small blind €0.01
franck19621962: posts big blind €0.02
*** HOLE CARDS ***
Dealt to caduceus369 [Jc 5c]
caduceus369: folds 
father2008: folds 
CIKO71131: folds 
mashallahh: raises €0.04 to €0.06
EasyToRule: folds 
franck19621962: calls €0.04
*** FLOP *** [9h Td 8d]
franck19621962: checks 
mashallahh: bets €0.09
franck19621962: folds 
Uncalled bet (€0.09) returned to mashallahh
mashallahh collected €0.13 from pot
mashallahh: doesn't show hand 
*** SUMMARY ***
Total pot €0.13 | Rake €0 
Board [9h Td 8d]
Seat 1: mashallahh (button) collected (€0.13)
Seat 2: EasyToRule (small blind) folded before Flop
Seat 3: franck19621962 (big blind) folded on the Flop
Seat 4: caduceus369 folded before Flop (didn't bet)
Seat 5: father2008 folded before Flop (didn't bet)
Seat 6: CIKO71131 folded before Flop (didn't bet)



PokerStars Zoom Hand #258129248763:  Hold'em No Limit (€0.01/€0.02) [ADM ID: M62C63044C87BABT] - 2025/10/15 1:17:26 CET [2025/10/14 19:17:26 ET]
Table 'Sirio' 6-max Seat #1 is the button
Seat 1: father2008 (€2 in chips) 
Seat 2: caduceus369 (€7.40 in chips) 
Seat 3: miridersa (€0.75 in chips) 
Seat 4: Warterror90 (€7.77 in chips) 
Seat 5: CIKO71131 (€0.80 in chips) 
Seat 6: mashallahh (€8.28 in chips) 
caduceus369: posts small blind €0.01
miridersa: posts big blind €0.02
*** HOLE CARDS ***
Dealt to caduceus369 [6h 6s]
Warterror90: folds 
CIKO71131: calls €0.02
mashallahh: raises €0.06 to €0.08
father2008: folds 
caduceus369: folds 
miridersa: folds 
CIKO71131: folds 
Uncalled bet (€0.06) returned to mashallahh
mashallahh collected €0.07 from pot
mashallahh: doesn't show hand 
*** SUMMARY ***
Total pot €0.07 | Rake €0 
Seat 1: father2008 (button) folded before Flop (didn't bet)
Seat 2: caduceus369 (small blind) folded before Flop
Seat 3: miridersa (big blind) folded before Flop
Seat 4: Warterror90 folded before Flop (didn't bet)
Seat 5: CIKO71131 folded before Flop
Seat 6: mashallahh collected (€0.07)



PokerStars Zoom Hand #258129254252:  Hold'em No Limit (€0.01/€0.02) [ADM ID: M62C63044C87BABT] - 2025/10/15 1:17:58 CET [2025/10/14 19:17:58 ET]
Table 'Sirio' 6-max Seat #1 is the button
Seat 1: caduceus369 (€7.39 in chips) 
Seat 2: bartolo608 (€0.79 in chips) 
Seat 3: BiscottinoXXL (€6.12 in chips) 
Seat 4: mashallahh (€7.70 in chips) 
Seat 5: EasyToRule (€2 in chips) 
Seat 6: franck19621962 (€0.98 in chips) 
bartolo608: posts small blind €0.01
BiscottinoXXL: posts big blind €0.02
*** HOLE CARDS ***
Dealt to caduceus369 [2s 3s]
mashallahh: folds 
EasyToRule: folds 
franck19621962: folds 
caduceus369: folds 
bartolo608: folds 
Uncalled bet (€0.01) returned to BiscottinoXXL
BiscottinoXXL collected €0.02 from pot
BiscottinoXXL: doesn't show hand 
*** SUMMARY ***
Total pot €0.02 | Rake €0 
Seat 1: caduceus369 (button) folded before Flop (didn't bet)
Seat 2: bartolo608 (small blind) folded before Flop
Seat 3: BiscottinoXXL (big blind) collected (€0.02)
Seat 4: mashallahh folded before Flop (didn't bet)
Seat 5: EasyToRule folded before Flop (didn't bet)
Seat 6: franck19621962 folded before Flop (didn't bet)



