PokerStars Zoom Hand #258128595245:  Hold'em No Limit (€0.01/€0.02) [ADM ID: M62C63044C87BABT] - 2025/10/15 0:18:39 CET [2025/10/14 18:18:39 ET]
Table 'Sirio' 6-max Seat #1 is the button
Seat 1: diesel197474 (€2.82 in chips) 
Seat 2: gas888 (€4.08 in chips) 
Seat 3: caduceus369 (€2 in chips) 
Seat 4: Diabolik0862 (€1.52 in chips) 
Seat 5: TheMule1454 (€1.84 in chips) 
Seat 6: 2PaperelaSgubio (€2.01 in chips) 
gas888: posts small blind €0.01
caduceus369: posts big blind €0.02
*** HOLE CARDS ***
Dealt to caduceus369 [Qc Ah]
Diabolik0862: folds 
TheMule1454: folds 
2PaperelaSgubio: raises €0.03 to €0.05
diesel197474: calls €0.05
gas888: calls €0.04
caduceus369: raises €0.19 to €0.24
2PaperelaSgubio: folds 
diesel197474: folds 
gas888: folds 
Uncalled bet (€0.19) returned to caduceus369
caduceus369 collected €0.20 from pot
caduceus369: doesn't show hand 
*** SUMMARY ***
Total pot €0.20 | Rake €0 
Seat 1: diesel197474 (button) folded before Flop
Seat 2: gas888 (small blind) folded before Flop
Seat 3: caduceus369 (big blind) collected (€0.20)
Seat 4: Diabolik0862 folded before Flop (didn't bet)
Seat 5: TheMule1454 folded before Flop (didn't bet)
Seat 6: 2PaperelaSgubio folded before Flop



PokerStars Zoom Hand #258128603454:  Hold'em No Limit (€0.01/€0.02) [ADM ID: M62C63044C87BABT] - 2025/10/15 0:19:18 CET [2025/10/14 18:19:18 ET]
Table 'Sirio' 6-max Seat #1 is the button
Seat 1: caduceus369 (€2.15 in chips) 
Seat 2: This Heat (€1.81 in chips) 
Seat 3: Fraxasso (€4.94 in chips) 
Seat 4: 2PaperelaSgubio (€1.99 in chips) 
Seat 5: teicano98 (€1.10 in chips) 
Seat 6: mashallahh (€3.31 in chips) 
This Heat: posts small blind €0.01
Fraxasso: posts big blind €0.02
*** HOLE CARDS ***
Dealt to caduceus369 [6s 3c]
2PaperelaSgubio: folds 
teicano98: folds 
mashallahh: folds 
caduceus369: folds 
This Heat: raises €0.04 to €0.06
Fraxasso: folds 
Uncalled bet (€0.04) returned to This Heat
This Heat collected €0.04 from pot
This Heat: doesn't show hand 
*** SUMMARY ***
Total pot €0.04 | Rake €0 
Seat 1: caduceus369 (button) folded before Flop (didn't bet)
Seat 2: This Heat (small blind) collected (€0.04)
Seat 3: Fraxasso (big blind) folded before Flop
Seat 4: 2PaperelaSgubio folded before Flop (didn't bet)
Seat 5: teicano98 folded before Flop (didn't bet)
Seat 6: mashallahh folded before Flop (didn't bet)



PokerStars Zoom Hand #258128604496:  Hold'em No Limit (€0.01/€0.02) [ADM ID: M62C63044C87BABT] - 2025/10/15 0:19:23 CET [2025/10/14 18:19:23 ET]
Table 'Sirio' 6-max Seat #1 is the button
Seat 1: father2008 (€2.02 in chips) 
Seat 2: caduceus369 (€2.15 in chips) 
Seat 3: CarlaBBruni (€3.09 in chips) 
Seat 4: TheMule1454 (€2.02 in chips) 
Seat 5: diesel197474 (€2.76 in chips) 
Seat 6: Crock361 (€2.08 in chips) 
caduceus369: posts small blind €0.01
CarlaBBruni: posts big blind €0.02
*** HOLE CARDS ***
Dealt to caduceus369 [Ac Tc]
TheMule1454: folds 
diesel197474: folds 
Crock361: folds 
father2008: raises €0.04 to €0.06
caduceus369: raises €0.14 to €0.20
CarlaBBruni: folds 
father2008: folds 
Uncalled bet (€0.14) returned to caduceus369
caduceus369 collected €0.14 from pot
caduceus369: doesn't show hand 
*** SUMMARY ***
Total pot €0.14 | Rake €0 
Seat 1: father2008 (button) folded before Flop
Seat 2: caduceus369 (small blind) collected (€0.14)
Seat 3: CarlaBBruni (big blind) folded before Flop
Seat 4: TheMule1454 folded before Flop (didn't bet)
Seat 5: diesel197474 folded before Flop (didn't bet)
Seat 6: Crock361 folded before Flop (didn't bet)



PokerStars Zoom Hand #258128611578:  Hold'em No Limit (€0.01/€0.02) [ADM ID: M62C63044C87BABT] - 2025/10/15 0:19:58 CET [2025/10/14 18:19:58 ET]
Table 'Sirio' 6-max Seat #1 is the button
Seat 1: teicano98 (€1.59 in chips) 
Seat 2: darkodiablo (€0.92 in chips) 
Seat 3: MARKNO73 (€0.75 in chips) 
Seat 4: Angelico82 (€1.17 in chips) 
Seat 5: caduceus369 (€2.23 in chips) 
Seat 6: danielekite (€1.71 in chips) 
darkodiablo: posts small blind €0.01
MARKNO73: posts big blind €0.02
*** HOLE CARDS ***
Dealt to caduceus369 [8c Kc]
Angelico82: raises €1.15 to €1.17 and is all-in
caduceus369: folds 
danielekite: calls €1.17
teicano98: folds 
darkodiablo: folds 
MARKNO73: folds 
*** FLOP *** [Jc 5h 3h]
*** TURN *** [Jc 5h 3h] [7c]
*** RIVER *** [Jc 5h 3h 7c] [Ad]
*** SHOW DOWN ***
Angelico82: shows [9c 9h] (a pair of Nines)
danielekite: shows [Qc Jh] (a pair of Jacks)
danielekite collected €2.24 from pot
*** SUMMARY ***
Total pot €2.37 | Rake €0.13 
Board [Jc 5h 3h 7c Ad]
Seat 1: teicano98 (button) folded before Flop (didn't bet)
Seat 2: darkodiablo (small blind) folded before Flop
Seat 3: MARKNO73 (big blind) folded before Flop
Seat 4: Angelico82 showed [9c 9h] and lost with a pair of Nines
Seat 5: caduceus369 folded before Flop (didn't bet)
Seat 6: danielekite showed [Qc Jh] and won (€2.24) with a pair of Jacks



PokerStars Zoom Hand #258128618737:  Hold'em No Limit (€0.01/€0.02) [ADM ID: M62C63044C87BABT] - 2025/10/15 0:20:33 CET [2025/10/14 18:20:33 ET]
Table 'Sirio' 6-max Seat #1 is the button
Seat 1: TheMule1454 (€2.05 in chips) 
Seat 2: diesel197474 (€2.83 in chips) 
Seat 3: meteco79 (€0.94 in chips) 
Seat 4: gas888 (€11.84 in chips) 
Seat 5: Begimon (€7.71 in chips) 
Seat 6: caduceus369 (€2.21 in chips) 
diesel197474: posts small blind €0.01
meteco79: posts big blind €0.02
*** HOLE CARDS ***
Dealt to caduceus369 [8c Jh]
gas888: folds 
Begimon: folds 
caduceus369: folds 
TheMule1454: folds 
diesel197474: folds 
Uncalled bet (€0.01) returned to meteco79
meteco79 collected €0.02 from pot
meteco79: doesn't show hand 
*** SUMMARY ***
Total pot €0.02 | Rake €0 
Seat 1: TheMule1454 (button) folded before Flop (didn't bet)
Seat 2: diesel197474 (small blind) folded before Flop
Seat 3: meteco79 (big blind) collected (€0.02)
Seat 4: gas888 folded before Flop (didn't bet)
Seat 5: Begimon folded before Flop (didn't bet)
Seat 6: caduceus369 folded before Flop (didn't bet)



PokerStars Zoom Hand #258128613053:  Hold'em No Limit (€0.01/€0.02) [ADM ID: M62C63044C87BABT] - 2025/10/15 0:20:05 CET [2025/10/14 18:20:05 ET]
Table 'Sirio' 6-max Seat #1 is the button
Seat 1: caduceus369 (€2.23 in chips) 
Seat 2: mashallahh (€5.42 in chips) 
Seat 3: Ohhhhyeahhh89 (€1 in chips) 
Seat 4: colosso2022 (€8.16 in chips) 
Seat 5: TheMule1454 (€2.02 in chips) 
Seat 6: ADRIAN0_MEIS (€3.61 in chips) 
mashallahh: posts small blind €0.01
Ohhhhyeahhh89: posts big blind €0.02
*** HOLE CARDS ***
Dealt to caduceus369 [6d Ts]
colosso2022: raises €0.02 to €0.04
TheMule1454: folds 
ADRIAN0_MEIS: calls €0.04
caduceus369: folds 
mashallahh: folds 
Ohhhhyeahhh89: calls €0.02
*** FLOP *** [2d Qh Qc]
Ohhhhyeahhh89: checks 
colosso2022: bets €0.02
ADRIAN0_MEIS: calls €0.02
Ohhhhyeahhh89: folds 
*** TURN *** [2d Qh Qc] [Ah]
colosso2022: bets €0.06
ADRIAN0_MEIS: raises €0.10 to €0.16
colosso2022: calls €0.10
*** RIVER *** [2d Qh Qc Ah] [Ks]
colosso2022: bets €0.06
ADRIAN0_MEIS: calls €0.06
*** SHOW DOWN ***
colosso2022: shows [As Tc] (two pair, Aces and Queens)
ADRIAN0_MEIS: shows [Ac Jd] (two pair, Aces and Queens)
colosso2022 collected €0.29 from pot
ADRIAN0_MEIS collected €0.29 from pot
*** SUMMARY ***
Total pot €0.61 | Rake €0.03 
Board [2d Qh Qc Ah Ks]
Seat 1: caduceus369 (button) folded before Flop (didn't bet)
Seat 2: mashallahh (small blind) folded before Flop
Seat 3: Ohhhhyeahhh89 (big blind) folded on the Flop
Seat 4: colosso2022 showed [As Tc] and won (€0.29) with two pair, Aces and Queens
Seat 5: TheMule1454 folded before Flop (didn't bet)
Seat 6: ADRIAN0_MEIS showed [Ac Jd] and won (€0.29) with two pair, Aces and Queens



PokerStars Zoom Hand #258128615389:  Hold'em No Limit (€0.01/€0.02) [ADM ID: M62C63044C87BABT] - 2025/10/15 0:20:16 CET [2025/10/14 18:20:16 ET]
Table 'Sirio' 6-max Seat #1 is the button
Seat 1: gas888 (€11.84 in chips) 
Seat 2: Fraxasso (€3.88 in chips) 
Seat 3: caduceus369 (€2.23 in chips) 
Seat 4: CarlaBBruni (€2.97 in chips) 
Seat 5: Agnese84 (€1.45 in chips) 
Seat 6: aurelios2 (€14.66 in chips) 
Fraxasso: posts small blind €0.01
caduceus369: posts big blind €0.02
*** HOLE CARDS ***
Dealt to caduceus369 [5c 3c]
CarlaBBruni: folds 
Agnese84: calls €0.02
aurelios2: raises €0.06 to €0.08
gas888: folds 
Fraxasso: folds 
caduceus369: folds 
Agnese84: calls €0.06
*** FLOP *** [Ac Ah Ad]
Agnese84: checks 
aurelios2: checks 
*** TURN *** [Ac Ah Ad] [Jd]
Agnese84: checks 
aurelios2: checks 
*** RIVER *** [Ac Ah Ad Jd] [7c]
Agnese84: bets €0.18
aurelios2: calls €0.18
*** SHOW DOWN ***
Agnese84: shows [2h As] (four of a kind, Aces)
aurelios2: mucks hand 
Agnese84 collected €0.52 from pot
*** SUMMARY ***
Total pot €0.55 | Rake €0.03 
Board [Ac Ah Ad Jd 7c]
Seat 1: gas888 (button) folded before Flop (didn't bet)
Seat 2: Fraxasso (small blind) folded before Flop
Seat 3: caduceus369 (big blind) folded before Flop
Seat 4: CarlaBBruni folded before Flop (didn't bet)
Seat 5: Agnese84 showed [2h As] and won (€0.52) with four of a kind, Aces
Seat 6: aurelios2 mucked [7s Ts]



PokerStars Zoom Hand #258128620605:  Hold'em No Limit (€0.01/€0.02) [ADM ID: M62C63044C87BABT] - 2025/10/15 0:20:41 CET [2025/10/14 18:20:41 ET]
Table 'Sirio' 6-max Seat #1 is the button
Seat 1: Warterror90 (€3.37 in chips) 
Seat 2: caduceus369 (€2.21 in chips) 
Seat 3: Fraxasso (€4.83 in chips) 
Seat 4: Crock361 (€3.24 in chips) 
Seat 5: gas888 (€11.84 in chips) 
Seat 6: TheMule1454 (€1.86 in chips) 
caduceus369: posts small blind €0.01
Fraxasso: posts big blind €0.02
*** HOLE CARDS ***
Dealt to caduceus369 [Ah 7c]
Crock361: raises €0.04 to €0.06
gas888: calls €0.06
TheMule1454: folds 
Warterror90: calls €0.06
caduceus369: folds 
Fraxasso: folds 
*** FLOP *** [Js 8s Jc]
Crock361: bets €0.10
gas888: folds 
Warterror90: folds 
Uncalled bet (€0.10) returned to Crock361
Crock361 collected €0.20 from pot
Crock361: doesn't show hand 
*** SUMMARY ***
Total pot €0.21 | Rake €0.01 
Board [Js 8s Jc]
Seat 1: Warterror90 (button) folded on the Flop
Seat 2: caduceus369 (small blind) folded before Flop
Seat 3: Fraxasso (big blind) folded before Flop
Seat 4: Crock361 collected (€0.20)
Seat 5: gas888 folded on the Flop
Seat 6: TheMule1454 folded before Flop (didn't bet)



PokerStars Zoom Hand #258128626429:  Hold'em No Limit (€0.01/€0.02) [ADM ID: M62C63044C87BABT] - 2025/10/15 0:21:10 CET [2025/10/14 18:21:10 ET]
Table 'Sirio' 6-max Seat #1 is the button
Seat 1: father2008 (€2.20 in chips) 
Seat 2: danielekite (€2.83 in chips) 
Seat 3: diesel197474 (€2.82 in chips) 
Seat 4: Diabolik0862 (€1.55 in chips) 
Seat 5: TheMule1454 (€2.13 in chips) 
Seat 6: caduceus369 (€2.20 in chips) 
danielekite: posts small blind €0.01
diesel197474: posts big blind €0.02
*** HOLE CARDS ***
Dealt to caduceus369 [5h 4s]
Diabolik0862: folds 
TheMule1454: folds 
caduceus369: folds 
father2008: raises €0.04 to €0.06
danielekite: calls €0.05
diesel197474: folds 
*** FLOP *** [2d 3c 2h]
danielekite: bets €0.26
father2008: folds 
Uncalled bet (€0.26) returned to danielekite
danielekite collected €0.14 from pot
danielekite: doesn't show hand 
*** SUMMARY ***
Total pot €0.14 | Rake €0 
Board [2d 3c 2h]
Seat 1: father2008 (button) folded on the Flop
Seat 2: danielekite (small blind) collected (€0.14)
Seat 3: diesel197474 (big blind) folded before Flop
Seat 4: Diabolik0862 folded before Flop (didn't bet)
Seat 5: TheMule1454 folded before Flop (didn't bet)
Seat 6: caduceus369 folded before Flop (didn't bet)



PokerStars Zoom Hand #258128623969:  Hold'em No Limit (€0.01/€0.02) [ADM ID: M62C63044C87BABT] - 2025/10/15 0:20:58 CET [2025/10/14 18:20:58 ET]
Table 'Sirio' 6-max Seat #1 is the button
Seat 1: Begimon (€7.71 in chips) 
Seat 2: CarlaBBruni (€2.38 in chips) 
Seat 3: mashallahh (€7.20 in chips) 
Seat 4: Samunho01 (€2.91 in chips) 
Seat 5: caduceus369 (€2.20 in chips) 
Seat 6: teicano98 (€1.15 in chips) 
CarlaBBruni: posts small blind €0.01
mashallahh: posts big blind €0.02
*** HOLE CARDS ***
Dealt to caduceus369 [Kd 4s]
Samunho01: folds 
caduceus369: folds 
teicano98: raises €0.02 to €0.04
Begimon: calls €0.04
CarlaBBruni: folds 
mashallahh: folds 
*** FLOP *** [7c Qs Qd]
teicano98: checks 
Begimon: checks 
*** TURN *** [7c Qs Qd] [6c]
teicano98: bets €0.08
Begimon: folds 
Uncalled bet (€0.08) returned to teicano98
teicano98 collected €0.11 from pot
teicano98: doesn't show hand 
*** SUMMARY ***
Total pot €0.11 | Rake €0 
Board [7c Qs Qd 6c]
Seat 1: Begimon (button) folded on the Turn
Seat 2: CarlaBBruni (small blind) folded before Flop
Seat 3: mashallahh (big blind) folded before Flop
Seat 4: Samunho01 folded before Flop (didn't bet)
Seat 5: caduceus369 folded before Flop (didn't bet)
Seat 6: teicano98 collected (€0.11)



PokerStars Zoom Hand #258128630157:  Hold'em No Limit (€0.01/€0.02) [ADM ID: M62C63044C87BABT] - 2025/10/15 0:21:28 CET [2025/10/14 18:21:28 ET]
Table 'Sirio' 6-max Seat #1 is the button
Seat 1: Crock361 (€1.94 in chips) 
Seat 2: mashallahh (€7.18 in chips) 
Seat 3: caduceus369 (€2.20 in chips) 
Seat 4: TheMule1454 (€2.33 in chips) 
Seat 5: 2PaperelaSgubio (€2.65 in chips) 
Seat 6: Fraxasso (€3.57 in chips) 
mashallahh: posts small blind €0.01
caduceus369: posts big blind €0.02
*** HOLE CARDS ***
Dealt to caduceus369 [8s 2d]
TheMule1454: folds 
2PaperelaSgubio: folds 
Fraxasso: folds 
Crock361: raises €0.04 to €0.06
mashallahh: folds 
caduceus369: folds 
Uncalled bet (€0.04) returned to Crock361
Crock361 collected €0.05 from pot
Crock361: doesn't show hand 
*** SUMMARY ***
Total pot €0.05 | Rake €0 
Seat 1: Crock361 (button) collected (€0.05)
Seat 2: mashallahh (small blind) folded before Flop
Seat 3: caduceus369 (big blind) folded before Flop
Seat 4: TheMule1454 folded before Flop (didn't bet)
Seat 5: 2PaperelaSgubio folded before Flop (didn't bet)
Seat 6: Fraxasso folded before Flop (didn't bet)



PokerStars Zoom Hand #258128636760:  Hold'em No Limit (€0.01/€0.02) [ADM ID: M62C63044C87BABT] - 2025/10/15 0:22:00 CET [2025/10/14 18:22:00 ET]
Table 'Sirio' 6-max Seat #1 is the button
Seat 1: caduceus369 (€2.17 in chips) 
Seat 2: Diabolik0862 (€1.46 in chips) 
Seat 3: CarlaBBruni (€2.94 in chips) 
Seat 4: diesel197474 (€1.71 in chips) 
Seat 5: Fraxasso (€4.14 in chips) 
Seat 6: ADRIAN0_MEIS (€3.55 in chips) 
Diabolik0862: posts small blind €0.01
CarlaBBruni: posts big blind €0.02
*** HOLE CARDS ***
Dealt to caduceus369 [3c 8d]
diesel197474: folds 
Fraxasso: folds 
ADRIAN0_MEIS: raises €0.04 to €0.06
caduceus369: folds 
Diabolik0862: folds 
CarlaBBruni: folds 
Uncalled bet (€0.04) returned to ADRIAN0_MEIS
ADRIAN0_MEIS collected €0.05 from pot
ADRIAN0_MEIS: doesn't show hand 
*** SUMMARY ***
Total pot €0.05 | Rake €0 
Seat 1: caduceus369 (button) folded before Flop (didn't bet)
Seat 2: Diabolik0862 (small blind) folded before Flop
Seat 3: CarlaBBruni (big blind) folded before Flop
Seat 4: diesel197474 folded before Flop (didn't bet)
Seat 5: Fraxasso folded before Flop (didn't bet)
Seat 6: ADRIAN0_MEIS collected (€0.05)



PokerStars Zoom Hand #258128628207:  Hold'em No Limit (€0.01/€0.02) [ADM ID: M62C63044C87BABT] - 2025/10/15 0:21:18 CET [2025/10/14 18:21:18 ET]
Table 'Sirio' 6-max Seat #1 is the button
Seat 1: 2PaperelaSgubio (€2 in chips) 
Seat 2: darkodiablo (€1.01 in chips) 
Seat 3: Warterror90 (€3.31 in chips) 
Seat 4: caduceus369 (€2.20 in chips) 
Seat 5: TheMule1454 (€2.02 in chips) 
Seat 6: CarlaBBruni (€2.37 in chips) 
darkodiablo: posts small blind €0.01
Warterror90: posts big blind €0.02
*** HOLE CARDS ***
Dealt to caduceus369 [7c 2d]
caduceus369: folds 
TheMule1454: folds 
CarlaBBruni: folds 
2PaperelaSgubio: folds 
darkodiablo: calls €0.01
Warterror90: raises €0.04 to €0.06
darkodiablo: calls €0.04
*** FLOP *** [Ah 2h 3s]
darkodiablo: checks 
Warterror90: checks 
*** TURN *** [Ah 2h 3s] [9h]
darkodiablo: bets €0.04
Warterror90: calls €0.04
*** RIVER *** [Ah 2h 3s 9h] [Kh]
darkodiablo: bets €0.02
Warterror90: calls €0.02
*** SHOW DOWN ***
darkodiablo: shows [7s 9s] (a pair of Nines)
Warterror90: shows [9d Jd] (a pair of Nines - Ace+King+Jack kicker)
Warterror90 collected €0.23 from pot
*** SUMMARY ***
Total pot €0.24 | Rake €0.01 
Board [Ah 2h 3s 9h Kh]
Seat 1: 2PaperelaSgubio (button) folded before Flop (didn't bet)
Seat 2: darkodiablo (small blind) showed [7s 9s] and lost with a pair of Nines
Seat 3: Warterror90 (big blind) showed [9d Jd] and won (€0.23) with a pair of Nines
Seat 4: caduceus369 folded before Flop (didn't bet)
Seat 5: TheMule1454 folded before Flop (didn't bet)
Seat 6: CarlaBBruni folded before Flop (didn't bet)



PokerStars Zoom Hand #258128640856:  Hold'em No Limit (€0.01/€0.02) [ADM ID: M62C63044C87BABT] - 2025/10/15 0:22:20 CET [2025/10/14 18:22:20 ET]
Table 'Sirio' 6-max Seat #1 is the button
Seat 1: danielekite (€3.27 in chips) 
Seat 2: father2008 (€2.12 in chips) 
Seat 3: diesel197474 (€2.92 in chips) 
Seat 4: caduceus369 (€2.17 in chips) 
Seat 5: teicano98 (€0.65 in chips) 
Seat 6: 2PaperelaSgubio (€2.62 in chips) 
father2008: posts small blind €0.01
diesel197474: posts big blind €0.02
*** HOLE CARDS ***
Dealt to caduceus369 [6s 7d]
caduceus369: folds 
teicano98: folds 
2PaperelaSgubio: raises €0.04 to €0.06
danielekite: folds 
father2008: folds 
diesel197474: folds 
Uncalled bet (€0.04) returned to 2PaperelaSgubio
2PaperelaSgubio collected €0.05 from pot
2PaperelaSgubio: doesn't show hand 
*** SUMMARY ***
Total pot €0.05 | Rake €0 
Seat 1: danielekite (button) folded before Flop (didn't bet)
Seat 2: father2008 (small blind) folded before Flop
Seat 3: diesel197474 (big blind) folded before Flop
Seat 4: caduceus369 folded before Flop (didn't bet)
Seat 5: teicano98 folded before Flop (didn't bet)
Seat 6: 2PaperelaSgubio collected (€0.05)



PokerStars Zoom Hand #258128638165:  Hold'em No Limit (€0.01/€0.02) [ADM ID: M62C63044C87BABT] - 2025/10/15 0:22:07 CET [2025/10/14 18:22:07 ET]
Table 'Sirio' 6-max Seat #1 is the button
Seat 1: 2PaperelaSgubio (€2.62 in chips) 
Seat 2: BiscottinoXXL (€2 in chips) 
Seat 3: gas888 (€11.78 in chips) 
Seat 4: caduceus369 (€2.17 in chips) 
Seat 5: diesel197474 (€2.92 in chips) 
Seat 6: TheMule1454 (€1.99 in chips) 
BiscottinoXXL: posts small blind €0.01
gas888: posts big blind €0.02
*** HOLE CARDS ***
Dealt to caduceus369 [Tc Kh]
caduceus369: folds 
diesel197474: folds 
TheMule1454: folds 
2PaperelaSgubio: folds 
BiscottinoXXL: raises €0.04 to €0.06
gas888: folds 
Uncalled bet (€0.04) returned to BiscottinoXXL
BiscottinoXXL collected €0.04 from pot
BiscottinoXXL: doesn't show hand 
*** SUMMARY ***
Total pot €0.04 | Rake €0 
Seat 1: 2PaperelaSgubio (button) folded before Flop (didn't bet)
Seat 2: BiscottinoXXL (small blind) collected (€0.04)
Seat 3: gas888 (big blind) folded before Flop
Seat 4: caduceus369 folded before Flop (didn't bet)
Seat 5: diesel197474 folded before Flop (didn't bet)
Seat 6: TheMule1454 folded before Flop (didn't bet)



PokerStars Zoom Hand #258128642538:  Hold'em No Limit (€0.01/€0.02) [ADM ID: M62C63044C87BABT] - 2025/10/15 0:22:28 CET [2025/10/14 18:22:28 ET]
Table 'Sirio' 6-max Seat #1 is the button
Seat 1: Ohhhhyeahhh89 (€0.79 in chips) 
Seat 2: caduceus369 (€2.17 in chips) 
Seat 3: danielekite (€3.27 in chips) 
Seat 4: TheMule1454 (€1.99 in chips) 
Seat 5: meteco79 (€1.13 in chips) 
Seat 6: colosso2022 (€7.91 in chips) 
caduceus369: posts small blind €0.01
danielekite: posts big blind €0.02
*** HOLE CARDS ***
Dealt to caduceus369 [7c Js]
TheMule1454: raises €0.05 to €0.07
meteco79: folds 
colosso2022: calls €0.07
Ohhhhyeahhh89: folds 
caduceus369: folds 
danielekite: folds 
*** FLOP *** [3c 3h 9d]
TheMule1454: bets €0.09
colosso2022: calls €0.09
*** TURN *** [3c 3h 9d] [9h]
TheMule1454: bets €0.17
colosso2022: calls €0.17
*** RIVER *** [3c 3h 9d 9h] [Kh]
TheMule1454: bets €0.33
colosso2022: calls €0.33
*** SHOW DOWN ***
TheMule1454: shows [Ts Td] (two pair, Tens and Nines)
colosso2022: mucks hand 
TheMule1454 collected €1.28 from pot
*** SUMMARY ***
Total pot €1.35 | Rake €0.07 
Board [3c 3h 9d 9h Kh]
Seat 1: Ohhhhyeahhh89 (button) folded before Flop (didn't bet)
Seat 2: caduceus369 (small blind) folded before Flop
Seat 3: danielekite (big blind) folded before Flop
Seat 4: TheMule1454 showed [Ts Td] and won (€1.28) with two pair, Tens and Nines
Seat 5: meteco79 folded before Flop (didn't bet)
Seat 6: colosso2022 mucked [6d Ad]



PokerStars Zoom Hand #258128634089:  Hold'em No Limit (€0.01/€0.02) [ADM ID: M62C63044C87BABT] - 2025/10/15 0:21:47 CET [2025/10/14 18:21:47 ET]
Table 'Sirio' 6-max Seat #1 is the button
Seat 1: Warterror90 (€1.11 in chips) 
Seat 2: caduceus369 (€2.18 in chips) 
Seat 3: Samunho01 (€2.91 in chips) 
Seat 4: mashallahh (€3.92 in chips) 
Seat 5: Crock361 (€2.18 in chips) 
Seat 6: teicano98 (€0.67 in chips) 
caduceus369: posts small blind €0.01
Samunho01: posts big blind €0.02
*** HOLE CARDS ***
Dealt to caduceus369 [Tc Qd]
mashallahh: folds 
Crock361: raises €0.04 to €0.06
teicano98: folds 
Warterror90: calls €0.06
caduceus369: folds 
Samunho01: folds 
*** FLOP *** [Js Kh 6h]
Crock361: checks 
Warterror90: bets €0.06
Crock361: calls €0.06
*** TURN *** [Js Kh 6h] [2d]
Crock361: checks 
Warterror90: bets €0.09
Crock361: calls €0.09
*** RIVER *** [Js Kh 6h 2d] [Kc]
Crock361: checks 
Warterror90: checks 
*** SHOW DOWN ***
Crock361: shows [Ah 2h] (two pair, Kings and Deuces)
Warterror90: mucks hand 
Crock361 collected €0.43 from pot
*** SUMMARY ***
Total pot €0.45 | Rake €0.02 
Board [Js Kh 6h 2d Kc]
Seat 1: Warterror90 (button) mucked [9h 8h]
Seat 2: caduceus369 (small blind) folded before Flop
Seat 3: Samunho01 (big blind) folded before Flop
Seat 4: mashallahh folded before Flop (didn't bet)
Seat 5: Crock361 showed [Ah 2h] and won (€0.43) with two pair, Kings and Deuces
Seat 6: teicano98 folded before Flop (didn't bet)



PokerStars Zoom Hand #258128643816:  Hold'em No Limit (€0.01/€0.02) [ADM ID: M62C63044C87BABT] - 2025/10/15 0:22:34 CET [2025/10/14 18:22:34 ET]
Table 'Sirio' 6-max Seat #1 is the button
Seat 1: father2008 (€2.11 in chips) 
Seat 2: danielekite (€3.25 in chips) 
Seat 3: bv0360 (€0.64 in chips) 
Seat 4: meteco79 (€1.13 in chips) 
Seat 5: Ohhhhyeahhh89 (€0.79 in chips) 
Seat 6: caduceus369 (€2.16 in chips) 
danielekite: posts small blind €0.01
bv0360: posts big blind €0.02
*** HOLE CARDS ***
Dealt to caduceus369 [9d 4c]
meteco79: folds 
Ohhhhyeahhh89: folds 
caduceus369: folds 
father2008: folds 
danielekite: raises €0.02 to €0.04
bv0360: calls €0.02
*** FLOP *** [Qd Jc 2d]
danielekite: bets €0.16
bv0360: raises €0.44 to €0.60 and is all-in
danielekite: calls €0.44
*** TURN *** [Qd Jc 2d] [4s]
*** RIVER *** [Qd Jc 2d 4s] [5h]
*** SHOW DOWN ***
danielekite: shows [Th 8c] (high card Queen)
bv0360: shows [4h Qs] (two pair, Queens and Fours)
bv0360 collected €1.21 from pot
*** SUMMARY ***
Total pot €1.28 | Rake €0.07 
Board [Qd Jc 2d 4s 5h]
Seat 1: father2008 (button) folded before Flop (didn't bet)
Seat 2: danielekite (small blind) showed [Th 8c] and lost with high card Queen
Seat 3: bv0360 (big blind) showed [4h Qs] and won (€1.21) with two pair, Queens and Fours
Seat 4: meteco79 folded before Flop (didn't bet)
Seat 5: Ohhhhyeahhh89 folded before Flop (didn't bet)
Seat 6: caduceus369 folded before Flop (didn't bet)



PokerStars Zoom Hand #258128644856:  Hold'em No Limit (€0.01/€0.02) [ADM ID: M62C63044C87BABT] - 2025/10/15 0:22:39 CET [2025/10/14 18:22:39 ET]
Table 'Sirio' 6-max Seat #1 is the button
Seat 1: meteco79 (€1.13 in chips) 
Seat 2: CarlaBBruni (€2.32 in chips) 
Seat 3: caduceus369 (€2.16 in chips) 
Seat 4: father2008 (€2 in chips) 
Seat 5: mashallahh (€7.62 in chips) 
Seat 6: Ohhhhyeahhh89 (€0.79 in chips) 
CarlaBBruni: posts small blind €0.01
caduceus369: posts big blind €0.02
*** HOLE CARDS ***
Dealt to caduceus369 [Js Jd]
father2008: folds 
mashallahh: folds 
Ohhhhyeahhh89: calls €0.02
meteco79: calls €0.02
CarlaBBruni: folds 
caduceus369: raises €0.10 to €0.12
Ohhhhyeahhh89: folds 
meteco79: calls €0.10
*** FLOP *** [6h 6s 8h]
caduceus369: bets €0.13
meteco79: calls €0.13
*** TURN *** [6h 6s 8h] [6d]
caduceus369: bets €0.17
meteco79: calls €0.17
*** RIVER *** [6h 6s 8h 6d] [7d]
caduceus369: checks 
meteco79: checks 
*** SHOW DOWN ***
caduceus369: shows [Js Jd] (a full house, Sixes full of Jacks)
meteco79: mucks hand 
caduceus369 collected €0.83 from pot
*** SUMMARY ***
Total pot €0.87 | Rake €0.04 
Board [6h 6s 8h 6d 7d]
Seat 1: meteco79 (button) mucked [Ks As]
Seat 2: CarlaBBruni (small blind) folded before Flop
Seat 3: caduceus369 (big blind) showed [Js Jd] and won (€0.83) with a full house, Sixes full of Jacks
Seat 4: father2008 folded before Flop (didn't bet)
Seat 5: mashallahh folded before Flop (didn't bet)
Seat 6: Ohhhhyeahhh89 folded before Flop



PokerStars Zoom Hand #258128654187:  Hold'em No Limit (€0.01/€0.02) [ADM ID: M62C63044C87BABT] - 2025/10/15 0:23:24 CET [2025/10/14 18:23:24 ET]
Table 'Sirio' 6-max Seat #1 is the button
Seat 1: caduceus369 (€2.57 in chips) 
Seat 2: 2PaperelaSgubio (€2.05 in chips) 
Seat 3: meteco79 (€0.71 in chips) 
Seat 4: Ohhhhyeahhh89 (€0.77 in chips) 
Seat 5: gas888 (€4.05 in chips) 
Seat 6: Fraxasso (€4.22 in chips) 
2PaperelaSgubio: posts small blind €0.01
meteco79: posts big blind €0.02
*** HOLE CARDS ***
Dealt to caduceus369 [4d 7s]
Ohhhhyeahhh89: calls €0.02
gas888: folds 
Fraxasso: folds 
caduceus369: folds 
2PaperelaSgubio: raises €0.08 to €0.10
meteco79: folds 
Ohhhhyeahhh89: calls €0.08
*** FLOP *** [Ts Kh 4h]
2PaperelaSgubio: bets €0.04
Ohhhhyeahhh89: folds 
Uncalled bet (€0.04) returned to 2PaperelaSgubio
2PaperelaSgubio collected €0.21 from pot
2PaperelaSgubio: doesn't show hand 
*** SUMMARY ***
Total pot €0.22 | Rake €0.01 
Board [Ts Kh 4h]
Seat 1: caduceus369 (button) folded before Flop (didn't bet)
Seat 2: 2PaperelaSgubio (small blind) collected (€0.21)
Seat 3: meteco79 (big blind) folded before Flop
Seat 4: Ohhhhyeahhh89 folded on the Flop
Seat 5: gas888 folded before Flop (didn't bet)
Seat 6: Fraxasso folded before Flop (didn't bet)



PokerStars Zoom Hand #258128658391:  Hold'em No Limit (€0.01/€0.02) [ADM ID: M62C63044C87BABT] - 2025/10/15 0:23:44 CET [2025/10/14 18:23:44 ET]
Table 'Sirio' 6-max Seat #1 is the button
Seat 1: Fraxasso (€5.05 in chips) 
Seat 2: maury999999 (€5.09 in chips) 
Seat 3: TheMule1454 (€2.05 in chips) 
Seat 4: Crock361 (€3.55 in chips) 
Seat 5: Warterror90 (€6.09 in chips) 
Seat 6: caduceus369 (€2.57 in chips) 
maury999999: posts small blind €0.01
TheMule1454: posts big blind €0.02
*** HOLE CARDS ***
Dealt to caduceus369 [Th 7h]
Crock361: folds 
Warterror90: folds 
caduceus369: folds 
Fraxasso: folds 
maury999999: folds 
Uncalled bet (€0.01) returned to TheMule1454
TheMule1454 collected €0.02 from pot
TheMule1454: doesn't show hand 
*** SUMMARY ***
Total pot €0.02 | Rake €0 
Seat 1: Fraxasso (button) folded before Flop (didn't bet)
Seat 2: maury999999 (small blind) folded before Flop
Seat 3: TheMule1454 (big blind) collected (€0.02)
Seat 4: Crock361 folded before Flop (didn't bet)
Seat 5: Warterror90 folded before Flop (didn't bet)
Seat 6: caduceus369 folded before Flop (didn't bet)



PokerStars Zoom Hand #258128657368:  Hold'em No Limit (€0.01/€0.02) [ADM ID: M62C63044C87BABT] - 2025/10/15 0:23:39 CET [2025/10/14 18:23:39 ET]
Table 'Sirio' 6-max Seat #1 is the button
Seat 1: Fraxasso (€4.22 in chips) 
Seat 2: fccmp (€0.88 in chips) 
Seat 3: Crock361 (€1.76 in chips) 
Seat 4: Rrrr322 (€1.52 in chips) 
Seat 5: caduceus369 (€2.57 in chips) 
Seat 6: TheMule1454 (€2.28 in chips) 
fccmp: posts small blind €0.01
Crock361: posts big blind €0.02
*** HOLE CARDS ***
Dealt to caduceus369 [Kd 7h]
Rrrr322: calls €0.02
caduceus369: folds 
TheMule1454: folds 
Fraxasso: folds 
fccmp: raises €0.06 to €0.08
Crock361: folds 
Rrrr322: calls €0.06
*** FLOP *** [Jh 2c Td]
fccmp: bets €0.80 and is all-in
Rrrr322: calls €0.80
*** TURN *** [Jh 2c Td] [3s]
*** RIVER *** [Jh 2c Td 3s] [Ks]
*** SHOW DOWN ***
fccmp: shows [Ad As] (a pair of Aces)
Rrrr322: shows [Jc Qs] (a pair of Jacks)
fccmp collected €1.69 from pot
*** SUMMARY ***
Total pot €1.78 | Rake €0.09 
Board [Jh 2c Td 3s Ks]
Seat 1: Fraxasso (button) folded before Flop (didn't bet)
Seat 2: fccmp (small blind) showed [Ad As] and won (€1.69) with a pair of Aces
Seat 3: Crock361 (big blind) folded before Flop
Seat 4: Rrrr322 showed [Jc Qs] and lost with a pair of Jacks
Seat 5: caduceus369 folded before Flop (didn't bet)
Seat 6: TheMule1454 folded before Flop (didn't bet)



PokerStars Zoom Hand #258128661102:  Hold'em No Limit (€0.01/€0.02) [ADM ID: M62C63044C87BABT] - 2025/10/15 0:23:57 CET [2025/10/14 18:23:57 ET]
Table 'Sirio' 6-max Seat #1 is the button
Seat 1: colosso2022 (€7.36 in chips) 
Seat 2: Crock361 (€1.98 in chips) 
Seat 3: gas888 (€3.19 in chips) 
Seat 4: 2PaperelaSgubio (€2.60 in chips) 
Seat 5: caduceus369 (€2.57 in chips) 
Seat 6: cryyh (€2.55 in chips) 
Crock361: posts small blind €0.01
gas888: posts big blind €0.02
*** HOLE CARDS ***
Dealt to caduceus369 [9d 7s]
2PaperelaSgubio: folds 
caduceus369: folds 
cryyh: raises €0.04 to €0.06
colosso2022: folds 
Crock361: folds 
gas888: folds 
Uncalled bet (€0.04) returned to cryyh
cryyh collected €0.05 from pot
cryyh: doesn't show hand 
*** SUMMARY ***
Total pot €0.05 | Rake €0 
Seat 1: colosso2022 (button) folded before Flop (didn't bet)
Seat 2: Crock361 (small blind) folded before Flop
Seat 3: gas888 (big blind) folded before Flop
Seat 4: 2PaperelaSgubio folded before Flop (didn't bet)
Seat 5: caduceus369 folded before Flop (didn't bet)
Seat 6: cryyh collected (€0.05)



PokerStars Zoom Hand #258128660060:  Hold'em No Limit (€0.01/€0.02) [ADM ID: M62C63044C87BABT] - 2025/10/15 0:23:52 CET [2025/10/14 18:23:52 ET]
Table 'Sirio' 6-max Seat #1 is the button
Seat 1: Fraxasso (€3.56 in chips) 
Seat 2: gas888 (€4.05 in chips) 
Seat 3: Crock361 (€3.55 in chips) 
Seat 4: caduceus369 (€2.57 in chips) 
Seat 5: teicano98 (€1.10 in chips) 
Seat 6: CarlaBBruni (€2.46 in chips) 
gas888: posts small blind €0.01
Crock361: posts big blind €0.02
*** HOLE CARDS ***
Dealt to caduceus369 [7d 5d]
caduceus369: folds 
teicano98: folds 
CarlaBBruni: raises €0.03 to €0.05
Fraxasso: folds 
gas888: folds 
Crock361: calls €0.03
*** FLOP *** [Jd 9s Td]
Crock361: checks 
CarlaBBruni: bets €0.04
Crock361: calls €0.04
*** TURN *** [Jd 9s Td] [5c]
Crock361: checks 
CarlaBBruni: bets €0.10
Crock361: calls €0.10
*** RIVER *** [Jd 9s Td 5c] [3c]
Crock361: checks 
CarlaBBruni: bets €0.56
Crock361: folds 
Uncalled bet (€0.56) returned to CarlaBBruni
CarlaBBruni collected €0.37 from pot
CarlaBBruni: doesn't show hand 
*** SUMMARY ***
Total pot €0.39 | Rake €0.02 
Board [Jd 9s Td 5c 3c]
Seat 1: Fraxasso (button) folded before Flop (didn't bet)
Seat 2: gas888 (small blind) folded before Flop
Seat 3: Crock361 (big blind) folded on the River
Seat 4: caduceus369 folded before Flop (didn't bet)
Seat 5: teicano98 folded before Flop (didn't bet)
Seat 6: CarlaBBruni collected (€0.37)



PokerStars Zoom Hand #258128662955:  Hold'em No Limit (€0.01/€0.02) [ADM ID: M62C63044C87BABT] - 2025/10/15 0:24:06 CET [2025/10/14 18:24:06 ET]
Table 'Sirio' 6-max Seat #1 is the button
Seat 1: Crock361 (€2.40 in chips) 
Seat 2: TheMule1454 (€2.26 in chips) 
Seat 3: caduceus369 (€2.57 in chips) 
Seat 4: Rrrr322 (€0.64 in chips) 
Seat 5: fccmp (€1.69 in chips) 
Seat 6: meteco79 (€0.77 in chips) 
TheMule1454: posts small blind €0.01
caduceus369: posts big blind €0.02
*** HOLE CARDS ***
Dealt to caduceus369 [9s Qc]
Rrrr322: calls €0.02
fccmp: calls €0.02
meteco79: calls €0.02
Crock361: folds 
TheMule1454: folds 
caduceus369: checks 
*** FLOP *** [6d 2h 5h]
caduceus369: checks 
Rrrr322: checks 
fccmp: bets €0.02
meteco79: folds 
caduceus369: calls €0.02
Rrrr322: calls €0.02
*** TURN *** [6d 2h 5h] [7h]
caduceus369: checks 
Rrrr322: checks 
fccmp: checks 
*** RIVER *** [6d 2h 5h 7h] [9d]
caduceus369: bets €0.04
Rrrr322: calls €0.04
fccmp: calls €0.04
*** SHOW DOWN ***
caduceus369: shows [9s Qc] (a pair of Nines)
Rrrr322: mucks hand 
fccmp: shows [As Ac] (a pair of Aces)
fccmp collected €0.26 from pot
*** SUMMARY ***
Total pot €0.27 | Rake €0.01 
Board [6d 2h 5h 7h 9d]
Seat 1: Crock361 (button) folded before Flop (didn't bet)
Seat 2: TheMule1454 (small blind) folded before Flop
Seat 3: caduceus369 (big blind) showed [9s Qc] and lost with a pair of Nines
Seat 4: Rrrr322 mucked [2d 4s]
Seat 5: fccmp showed [As Ac] and won (€0.26) with a pair of Aces
Seat 6: meteco79 folded on the Flop



PokerStars Zoom Hand #258128672859:  Hold'em No Limit (€0.01/€0.02) [ADM ID: M62C63044C87BABT] - 2025/10/15 0:24:54 CET [2025/10/14 18:24:54 ET]
Table 'Sirio' 6-max Seat #1 is the button
Seat 1: diesel197474 (€3.17 in chips) 
Seat 2: caduceus369 (€2.49 in chips) 
Seat 3: Rrrr322 (€0.56 in chips) 
Seat 4: fccmp (€1.87 in chips) 
Seat 5: aurelios2 (€13.88 in chips) 
Seat 6: 2PaperelaSgubio (€2.12 in chips) 
caduceus369: posts small blind €0.01
Rrrr322: posts big blind €0.02
*** HOLE CARDS ***
Dealt to caduceus369 [9h 2d]
fccmp: folds 
aurelios2: folds 
2PaperelaSgubio: folds 
diesel197474: folds 
caduceus369: folds 
Uncalled bet (€0.01) returned to Rrrr322
Rrrr322 collected €0.02 from pot
Rrrr322: doesn't show hand 
*** SUMMARY ***
Total pot €0.02 | Rake €0 
Seat 1: diesel197474 (button) folded before Flop (didn't bet)
Seat 2: caduceus369 (small blind) folded before Flop
Seat 3: Rrrr322 (big blind) collected (€0.02)
Seat 4: fccmp folded before Flop (didn't bet)
Seat 5: aurelios2 folded before Flop (didn't bet)
Seat 6: 2PaperelaSgubio folded before Flop (didn't bet)



PokerStars Zoom Hand #258128674557:  Hold'em No Limit (€0.01/€0.02) [ADM ID: M62C63044C87BABT] - 2025/10/15 0:25:01 CET [2025/10/14 18:25:01 ET]
Table 'Sirio' 6-max Seat #1 is the button
Seat 1: caduceus369 (€2.48 in chips) 
Seat 2: teicano98 (€1.04 in chips) 
Seat 3: plutonexx (€1.20 in chips) 
Seat 4: cryyh (€2.64 in chips) 
Seat 5: CarlaBBruni (€2.63 in chips) 
Seat 6: TheMule1454 (€1.99 in chips) 
teicano98: posts small blind €0.01
plutonexx: posts big blind €0.02
*** HOLE CARDS ***
Dealt to caduceus369 [Ad 3h]
cryyh: folds 
CarlaBBruni: folds 
TheMule1454: folds 
caduceus369: raises €0.04 to €0.06
teicano98: folds 
plutonexx: calls €0.04
*** FLOP *** [3d Jc Ts]
plutonexx: checks 
caduceus369: checks 
*** TURN *** [3d Jc Ts] [Ah]
plutonexx: checks 
caduceus369: bets €0.07
plutonexx: folds 
Uncalled bet (€0.07) returned to caduceus369
caduceus369 collected €0.13 from pot
caduceus369: doesn't show hand 
*** SUMMARY ***
Total pot €0.13 | Rake €0 
Board [3d Jc Ts Ah]
Seat 1: caduceus369 (button) collected (€0.13)
Seat 2: teicano98 (small blind) folded before Flop
Seat 3: plutonexx (big blind) folded on the Turn
Seat 4: cryyh folded before Flop (didn't bet)
Seat 5: CarlaBBruni folded before Flop (didn't bet)
Seat 6: TheMule1454 folded before Flop (didn't bet)



PokerStars Zoom Hand #258128685394:  Hold'em No Limit (€0.01/€0.02) [ADM ID: M62C63044C87BABT] - 2025/10/15 0:25:54 CET [2025/10/14 18:25:54 ET]
Table 'Sirio' 6-max Seat #1 is the button
Seat 1: maury999999 (€4.90 in chips) 
Seat 2: ADRIAN0_MEIS (€3.78 in chips) 
Seat 3: Warterror90 (€6.51 in chips) 
Seat 4: Fraxasso (€4.44 in chips) 
Seat 5: caduceus369 (€2.55 in chips) 
Seat 6: danielekite (€3.10 in chips) 
ADRIAN0_MEIS: posts small blind €0.01
Warterror90: posts big blind €0.02
*** HOLE CARDS ***
Dealt to caduceus369 [Qh 2d]
Fraxasso: folds 
caduceus369: folds 
danielekite: raises €0.02 to €0.04
maury999999: folds 
ADRIAN0_MEIS: folds 
Warterror90: folds 
Uncalled bet (€0.02) returned to danielekite
danielekite collected €0.05 from pot
danielekite: doesn't show hand 
*** SUMMARY ***
Total pot €0.05 | Rake €0 
Seat 1: maury999999 (button) folded before Flop (didn't bet)
Seat 2: ADRIAN0_MEIS (small blind) folded before Flop
Seat 3: Warterror90 (big blind) folded before Flop
Seat 4: Fraxasso folded before Flop (didn't bet)
Seat 5: caduceus369 folded before Flop (didn't bet)
Seat 6: danielekite collected (€0.05)



PokerStars Zoom Hand #258128689434:  Hold'em No Limit (€0.01/€0.02) [ADM ID: M62C63044C87BABT] - 2025/10/15 0:26:13 CET [2025/10/14 18:26:13 ET]
Table 'Sirio' 6-max Seat #1 is the button
Seat 1: meteco79 (€0.64 in chips) 
Seat 2: Warterror90 (€1.63 in chips) 
Seat 3: BiscottinoXXL (€2 in chips) 
Seat 4: caduceus369 (€2.55 in chips) 
Seat 5: Samunho01 (€2.58 in chips) 
Seat 6: gas888 (€0.95 in chips) 
Warterror90: posts small blind €0.01
BiscottinoXXL: posts big blind €0.02
*** HOLE CARDS ***
Dealt to caduceus369 [9c 9s]
caduceus369: raises €0.04 to €0.06
Samunho01: folds 
gas888: folds 
meteco79: folds 
Warterror90: folds 
BiscottinoXXL: calls €0.04
*** FLOP *** [Jh 2h 9h]
BiscottinoXXL: checks 
caduceus369: bets €0.07
BiscottinoXXL: folds 
Uncalled bet (€0.07) returned to caduceus369
caduceus369 collected €0.13 from pot
caduceus369: doesn't show hand 
*** SUMMARY ***
Total pot €0.13 | Rake €0 
Board [Jh 2h 9h]
Seat 1: meteco79 (button) folded before Flop (didn't bet)
Seat 2: Warterror90 (small blind) folded before Flop
Seat 3: BiscottinoXXL (big blind) folded on the Flop
Seat 4: caduceus369 collected (€0.13)
Seat 5: Samunho01 folded before Flop (didn't bet)
Seat 6: gas888 folded before Flop (didn't bet)



PokerStars Zoom Hand #258128686925:  Hold'em No Limit (€0.01/€0.02) [ADM ID: M62C63044C87BABT] - 2025/10/15 0:26:01 CET [2025/10/14 18:26:01 ET]
Table 'Sirio' 6-max Seat #1 is the button
Seat 1: toscano31 (€1.24 in chips) 
Seat 2: Fraxasso (€4.44 in chips) 
Seat 3: father2008 (€2 in chips) 
Seat 4: aurelios2 (€13.28 in chips) 
Seat 5: bv0360 (€0.97 in chips) 
Seat 6: caduceus369 (€2.55 in chips) 
Fraxasso: posts small blind €0.01
father2008: posts big blind €0.02
*** HOLE CARDS ***
Dealt to caduceus369 [7d Tc]
aurelios2: folds 
bv0360: raises €0.02 to €0.04
caduceus369: folds 
toscano31: calls €0.04
Fraxasso: calls €0.03
father2008: calls €0.02
*** FLOP *** [9d 4d 5s]
Fraxasso: checks 
father2008: checks 
bv0360: checks 
toscano31: checks 
*** TURN *** [9d 4d 5s] [Qs]
Fraxasso: checks 
father2008: checks 
bv0360: checks 
toscano31: checks 
*** RIVER *** [9d 4d 5s Qs] [4c]
Fraxasso: checks 
father2008: checks 
bv0360: checks 
toscano31: bets €1.20 and is all-in
Fraxasso: folds 
father2008: folds 
bv0360: folds 
Uncalled bet (€1.20) returned to toscano31
toscano31 collected €0.16 from pot
toscano31: doesn't show hand 
*** SUMMARY ***
Total pot €0.16 | Rake €0 
Board [9d 4d 5s Qs 4c]
Seat 1: toscano31 (button) collected (€0.16)
Seat 2: Fraxasso (small blind) folded on the River
Seat 3: father2008 (big blind) folded on the River
Seat 4: aurelios2 folded before Flop (didn't bet)
Seat 5: bv0360 folded on the River
Seat 6: caduceus369 folded before Flop (didn't bet)



PokerStars Zoom Hand #258128695013:  Hold'em No Limit (€0.01/€0.02) [ADM ID: M62C63044C87BABT] - 2025/10/15 0:26:40 CET [2025/10/14 18:26:40 ET]
Table 'Sirio' 6-max Seat #1 is the button
Seat 1: BiscottinoXXL (€2 in chips) 
Seat 2: colosso2022 (€7.07 in chips) 
Seat 3: caduceus369 (€2.62 in chips) 
Seat 4: mashallahh (€5.36 in chips) 
Seat 5: father2008 (€2.04 in chips) 
Seat 6: gas888 (€3.04 in chips) 
colosso2022: posts small blind €0.01
caduceus369: posts big blind €0.02
*** HOLE CARDS ***
Dealt to caduceus369 [Ah 8h]
mashallahh: folds 
father2008 has timed out
father2008: folds 
gas888: folds 
BiscottinoXXL: folds 
colosso2022: calls €0.01
caduceus369: checks 
*** FLOP *** [5c 2h 3c]
colosso2022: checks 
caduceus369: checks 
*** TURN *** [5c 2h 3c] [Kh]
colosso2022: checks 
caduceus369: bets €0.02
colosso2022: raises €0.08 to €0.10
caduceus369: calls €0.08
*** RIVER *** [5c 2h 3c Kh] [Qh]
colosso2022: bets €0.23
caduceus369: raises €0.37 to €0.60
colosso2022: calls €0.37
*** SHOW DOWN ***
caduceus369: shows [Ah 8h] (a flush, Ace high)
colosso2022: mucks hand 
caduceus369 collected €1.37 from pot
*** SUMMARY ***
Total pot €1.44 | Rake €0.07 
Board [5c 2h 3c Kh Qh]
Seat 1: BiscottinoXXL (button) folded before Flop (didn't bet)
Seat 2: colosso2022 (small blind) mucked [Jh Ks]
Seat 3: caduceus369 (big blind) showed [Ah 8h] and won (€1.37) with a flush, Ace high
Seat 4: mashallahh folded before Flop (didn't bet)
Seat 5: father2008 folded before Flop (didn't bet)
Seat 6: gas888 folded before Flop (didn't bet)



PokerStars Zoom Hand #258128706478:  Hold'em No Limit (€0.01/€0.02) [ADM ID: M62C63044C87BABT] - 2025/10/15 0:27:35 CET [2025/10/14 18:27:35 ET]
Table 'Sirio' 6-max Seat #1 is the button
Seat 1: colosso2022 (€6.35 in chips) 
Seat 2: caduceus369 (€3.27 in chips) 
Seat 3: plutonexx (€2.11 in chips) 
Seat 4: Vitto oolin (€1.37 in chips) 
Seat 5: BiscottinoXXL (€2.07 in chips) 
Seat 6: TheMule1454 (€1.97 in chips) 
caduceus369: posts small blind €0.01
plutonexx: posts big blind €0.02
*** HOLE CARDS ***
Dealt to caduceus369 [Tc Ad]
Vitto oolin: folds 
BiscottinoXXL: folds 
TheMule1454: folds 
colosso2022: folds 
caduceus369: raises €0.04 to €0.06
plutonexx: calls €0.04
*** FLOP *** [8s 6h Qc]
caduceus369: checks 
plutonexx: bets €0.06
caduceus369: folds 
Uncalled bet (€0.06) returned to plutonexx
plutonexx collected €0.12 from pot
plutonexx: doesn't show hand 
*** SUMMARY ***
Total pot €0.12 | Rake €0 
Board [8s 6h Qc]
Seat 1: colosso2022 (button) folded before Flop (didn't bet)
Seat 2: caduceus369 (small blind) folded on the Flop
Seat 3: plutonexx (big blind) collected (€0.12)
Seat 4: Vitto oolin folded before Flop (didn't bet)
Seat 5: BiscottinoXXL folded before Flop (didn't bet)
Seat 6: TheMule1454 folded before Flop (didn't bet)



PokerStars Zoom Hand #258128715719:  Hold'em No Limit (€0.01/€0.02) [ADM ID: M62C63044C87BABT] - 2025/10/15 0:28:20 CET [2025/10/14 18:28:20 ET]
Table 'Sirio' 6-max Seat #1 is the button
Seat 1: caduceus369 (€3.21 in chips) 
Seat 2: Crock361 (€2.44 in chips) 
Seat 3: CarlaBBruni (€2.66 in chips) 
Seat 4: mashallahh (€5.32 in chips) 
Seat 5: Agnese84 (€2.87 in chips) 
Seat 6: maury999999 (€4.23 in chips) 
Crock361: posts small blind €0.01
CarlaBBruni: posts big blind €0.02
*** HOLE CARDS ***
Dealt to caduceus369 [Ts Qh]
mashallahh: folds 
Agnese84: calls €0.02
maury999999: folds 
caduceus369: folds 
Crock361: raises €0.06 to €0.08
CarlaBBruni: calls €0.06
Agnese84: calls €0.06
*** FLOP *** [Ac 2d Kc]
Crock361: checks 
CarlaBBruni: checks 
Agnese84: bets €0.08
Crock361: raises €0.39 to €0.47
CarlaBBruni: folds 
Agnese84: folds 
Uncalled bet (€0.39) returned to Crock361
Crock361 collected €0.38 from pot
Crock361: doesn't show hand 
*** SUMMARY ***
Total pot €0.40 | Rake €0.02 
Board [Ac 2d Kc]
Seat 1: caduceus369 (button) folded before Flop (didn't bet)
Seat 2: Crock361 (small blind) collected (€0.38)
Seat 3: CarlaBBruni (big blind) folded on the Flop
Seat 4: mashallahh folded before Flop (didn't bet)
Seat 5: Agnese84 folded on the Flop
Seat 6: maury999999 folded before Flop (didn't bet)



PokerStars Zoom Hand #258128718047:  Hold'em No Limit (€0.01/€0.02) [ADM ID: M62C63044C87BABT] - 2025/10/15 0:28:32 CET [2025/10/14 18:28:32 ET]
Table 'Sirio' 6-max Seat #1 is the button
Seat 1: TheMule1454 (€1.90 in chips) 
Seat 2: Catania838 (€2.01 in chips) 
Seat 3: ADRIAN0_MEIS (€3.84 in chips) 
Seat 4: mashallahh (€3.83 in chips) 
Seat 5: maury999999 (€4.21 in chips) 
Seat 6: caduceus369 (€3.21 in chips) 
Catania838: posts small blind €0.01
ADRIAN0_MEIS: posts big blind €0.02
*** HOLE CARDS ***
Dealt to caduceus369 [Kh Qd]
mashallahh: folds 
maury999999: raises €0.02 to €0.04
caduceus369: raises €0.10 to €0.14
TheMule1454: folds 
Catania838: folds 
ADRIAN0_MEIS: folds 
maury999999: calls €0.10
*** FLOP *** [4c 9d 3d]
maury999999: checks 
caduceus369: bets €0.10
maury999999: folds 
Uncalled bet (€0.10) returned to caduceus369
caduceus369 collected €0.30 from pot
caduceus369: doesn't show hand 
*** SUMMARY ***
Total pot €0.31 | Rake €0.01 
Board [4c 9d 3d]
Seat 1: TheMule1454 (button) folded before Flop (didn't bet)
Seat 2: Catania838 (small blind) folded before Flop
Seat 3: ADRIAN0_MEIS (big blind) folded before Flop
Seat 4: mashallahh folded before Flop (didn't bet)
Seat 5: maury999999 folded on the Flop
Seat 6: caduceus369 collected (€0.30)



PokerStars Zoom Hand #258128731453:  Hold'em No Limit (€0.01/€0.02) [ADM ID: M62C63044C87BABT] - 2025/10/15 0:29:37 CET [2025/10/14 18:29:37 ET]
Table 'Sirio' 6-max Seat #1 is the button
Seat 1: Fraxasso (€3.49 in chips) 
Seat 2: colosso2022 (€6.10 in chips) 
Seat 3: aurelios2 (€11.13 in chips) 
Seat 4: BiscottinoXXL (€2.38 in chips) 
Seat 5: caduceus369 (€3.37 in chips) 
Seat 6: maury999999 (€4.07 in chips) 
colosso2022: posts small blind €0.01
aurelios2: posts big blind €0.02
*** HOLE CARDS ***
Dealt to caduceus369 [2s 5h]
BiscottinoXXL: folds 
caduceus369: folds 
maury999999: folds 
Fraxasso: folds 
colosso2022: folds 
Uncalled bet (€0.01) returned to aurelios2
aurelios2 collected €0.02 from pot
aurelios2: doesn't show hand 
*** SUMMARY ***
Total pot €0.02 | Rake €0 
Seat 1: Fraxasso (button) folded before Flop (didn't bet)
Seat 2: colosso2022 (small blind) folded before Flop
Seat 3: aurelios2 (big blind) collected (€0.02)
Seat 4: BiscottinoXXL folded before Flop (didn't bet)
Seat 5: caduceus369 folded before Flop (didn't bet)
Seat 6: maury999999 folded before Flop (didn't bet)



PokerStars Zoom Hand #258128732506:  Hold'em No Limit (€0.01/€0.02) [ADM ID: M62C63044C87BABT] - 2025/10/15 0:29:42 CET [2025/10/14 18:29:42 ET]
Table 'Sirio' 6-max Seat #1 is the button
Seat 1: Fraxasso (€4.50 in chips) 
Seat 2: maury999999 (€4.07 in chips) 
Seat 3: caduceus369 (€3.37 in chips) 
Seat 4: Crock361 (€3.29 in chips) 
Seat 5: Freddy15081988 (€0.99 in chips) 
Seat 6: TheMule1454 (€1.55 in chips) 
maury999999: posts small blind €0.01
caduceus369: posts big blind €0.02
*** HOLE CARDS ***
Dealt to caduceus369 [7s Qs]
Crock361: folds 
Freddy15081988: calls €0.02
TheMule1454: folds 
Fraxasso: folds 
maury999999: folds 
caduceus369: checks 
*** FLOP *** [7d 2s Js]
caduceus369: checks 
Freddy15081988: checks 
*** TURN *** [7d 2s Js] [8c]
caduceus369: bets €0.02
Freddy15081988: calls €0.02
*** RIVER *** [7d 2s Js 8c] [Kh]
caduceus369: checks 
Freddy15081988: checks 
*** SHOW DOWN ***
caduceus369: shows [7s Qs] (a pair of Sevens)
Freddy15081988: mucks hand 
caduceus369 collected €0.09 from pot
*** SUMMARY ***
Total pot €0.09 | Rake €0 
Board [7d 2s Js 8c Kh]
Seat 1: Fraxasso (button) folded before Flop (didn't bet)
Seat 2: maury999999 (small blind) folded before Flop
Seat 3: caduceus369 (big blind) showed [7s Qs] and won (€0.09) with a pair of Sevens
Seat 4: Crock361 folded before Flop (didn't bet)
Seat 5: Freddy15081988 mucked [4h Qd]
Seat 6: TheMule1454 folded before Flop (didn't bet)



PokerStars Zoom Hand #258128741503:  Hold'em No Limit (€0.01/€0.02) [ADM ID: M62C63044C87BABT] - 2025/10/15 0:30:27 CET [2025/10/14 18:30:27 ET]
Table 'Sirio' 6-max Seat #1 is the button
Seat 1: aurelios2 (€10.90 in chips) 
Seat 2: Fraxasso (€3.25 in chips) 
Seat 3: Freddy15081988 (€0.95 in chips) 
Seat 4: caduceus369 (€3.42 in chips) 
Seat 5: 2PaperelaSgubio (€2.11 in chips) 
Seat 6: CarlaBBruni (€2.34 in chips) 
Fraxasso: posts small blind €0.01
Freddy15081988: posts big blind €0.02
*** HOLE CARDS ***
Dealt to caduceus369 [2d 3s]
caduceus369: folds 
2PaperelaSgubio: folds 
CarlaBBruni: folds 
aurelios2: folds 
Fraxasso: folds 
Uncalled bet (€0.01) returned to Freddy15081988
Freddy15081988 collected €0.02 from pot
Freddy15081988: doesn't show hand 
*** SUMMARY ***
Total pot €0.02 | Rake €0 
Seat 1: aurelios2 (button) folded before Flop (didn't bet)
Seat 2: Fraxasso (small blind) folded before Flop
Seat 3: Freddy15081988 (big blind) collected (€0.02)
Seat 4: caduceus369 folded before Flop (didn't bet)
Seat 5: 2PaperelaSgubio folded before Flop (didn't bet)
Seat 6: CarlaBBruni folded before Flop (didn't bet)



PokerStars Zoom Hand #258128742952:  Hold'em No Limit (€0.01/€0.02) [ADM ID: M62C63044C87BABT] - 2025/10/15 0:30:34 CET [2025/10/14 18:30:34 ET]
Table 'Sirio' 6-max Seat #1 is the button
Seat 1: CIKO71131 (€0.86 in chips) 
Seat 2: McSup (€1.94 in chips) 
Seat 3: Begimon (€12.65 in chips) 
Seat 4: caduceus369 (€3.41 in chips) 
Seat 5: franck19621962 (€1.66 in chips) 
Seat 6: TheMule1454 (€3.08 in chips) 
McSup: posts small blind €0.01
Begimon: posts big blind €0.02
*** HOLE CARDS ***
Dealt to caduceus369 [Qs 8c]
caduceus369: folds 
franck19621962: folds 
TheMule1454: folds 
CIKO71131: folds 
McSup: raises €0.04 to €0.06
Begimon: calls €0.04
*** FLOP *** [7d 3s Qc]
McSup: checks 
Begimon: checks 
*** TURN *** [7d 3s Qc] [5d]
McSup: checks 
Begimon: checks 
*** RIVER *** [7d 3s Qc 5d] [6s]
McSup: bets €0.06
Begimon: folds 
Uncalled bet (€0.06) returned to McSup
McSup collected €0.12 from pot
McSup: doesn't show hand 
*** SUMMARY ***
Total pot €0.12 | Rake €0 
Board [7d 3s Qc 5d 6s]
Seat 1: CIKO71131 (button) folded before Flop (didn't bet)
Seat 2: McSup (small blind) collected (€0.12)
Seat 3: Begimon (big blind) folded on the River
Seat 4: caduceus369 folded before Flop (didn't bet)
Seat 5: franck19621962 folded before Flop (didn't bet)
Seat 6: TheMule1454 folded before Flop (didn't bet)



PokerStars Zoom Hand #258128742185:  Hold'em No Limit (€0.01/€0.02) [ADM ID: M62C63044C87BABT] - 2025/10/15 0:30:30 CET [2025/10/14 18:30:30 ET]
Table 'Sirio' 6-max Seat #1 is the button
Seat 1: maury999999 (€7.30 in chips) 
Seat 2: caduceus369 (€3.42 in chips) 
Seat 3: Agnese84 (€2.70 in chips) 
Seat 4: Begimon (€12.65 in chips) 
Seat 5: mashallahh (€5.11 in chips) 
Seat 6: CarlaBBruni (€2.34 in chips) 
caduceus369: posts small blind €0.01
Agnese84: posts big blind €0.02
*** HOLE CARDS ***
Dealt to caduceus369 [6s 8c]
Begimon: folds 
mashallahh: folds 
CarlaBBruni: raises €0.03 to €0.05
maury999999: folds 
caduceus369: folds 
Agnese84: calls €0.03
*** FLOP *** [5h 3s 4d]
Agnese84: bets €0.02
CarlaBBruni: raises €0.04 to €0.06
Agnese84: calls €0.04
*** TURN *** [5h 3s 4d] [Td]
Agnese84: bets €0.11
CarlaBBruni: calls €0.11
*** RIVER *** [5h 3s 4d Td] [8s]
Agnese84: bets €0.14
CarlaBBruni: calls €0.14
*** SHOW DOWN ***
Agnese84: shows [9c Th] (a pair of Tens)
CarlaBBruni: shows [Qs Qh] (a pair of Queens)
CarlaBBruni collected €0.69 from pot
*** SUMMARY ***
Total pot €0.73 | Rake €0.04 
Board [5h 3s 4d Td 8s]
Seat 1: maury999999 (button) folded before Flop (didn't bet)
Seat 2: caduceus369 (small blind) folded before Flop
Seat 3: Agnese84 (big blind) showed [9c Th] and lost with a pair of Tens
Seat 4: Begimon folded before Flop (didn't bet)
Seat 5: mashallahh folded before Flop (didn't bet)
Seat 6: CarlaBBruni showed [Qs Qh] and won (€0.69) with a pair of Queens



PokerStars Zoom Hand #258128746654:  Hold'em No Limit (€0.01/€0.02) [ADM ID: M62C63044C87BABT] - 2025/10/15 0:30:52 CET [2025/10/14 18:30:52 ET]
Table 'Sirio' 6-max Seat #1 is the button
Seat 1: Fraxasso (€3.22 in chips) 
Seat 2: TheMule1454 (€1.53 in chips) 
Seat 3: caduceus369 (€3.41 in chips) 
Seat 4: McSup (€2.41 in chips) 
Seat 5: Warterror90 (€2.58 in chips) 
Seat 6: 2PaperelaSgubio (€2.11 in chips) 
TheMule1454: posts small blind €0.01
caduceus369: posts big blind €0.02
*** HOLE CARDS ***
Dealt to caduceus369 [7s 3d]
McSup: raises €0.04 to €0.06
Warterror90: folds 
2PaperelaSgubio: folds 
Fraxasso: folds 
TheMule1454: folds 
caduceus369: calls €0.04
*** FLOP *** [5d 2s Qd]
caduceus369: checks 
McSup: bets €0.07
caduceus369: folds 
Uncalled bet (€0.07) returned to McSup
McSup collected €0.13 from pot
McSup: doesn't show hand 
*** SUMMARY ***
Total pot €0.13 | Rake €0 
Board [5d 2s Qd]
Seat 1: Fraxasso (button) folded before Flop (didn't bet)
Seat 2: TheMule1454 (small blind) folded before Flop
Seat 3: caduceus369 (big blind) folded on the Flop
Seat 4: McSup collected (€0.13)
Seat 5: Warterror90 folded before Flop (didn't bet)
Seat 6: 2PaperelaSgubio folded before Flop (didn't bet)



PokerStars Zoom Hand #258128756611:  Hold'em No Limit (€0.01/€0.02) [ADM ID: M62C63044C87BABT] - 2025/10/15 0:31:42 CET [2025/10/14 18:31:42 ET]
Table 'Sirio' 6-max Seat #1 is the button
Seat 1: caduceus369 (€3.35 in chips) 
Seat 2: TheMule1454 (€3.13 in chips) 
Seat 3: 66lanci66 (€2 in chips) 
Seat 4: 2PaperelaSgubio (€2.63 in chips) 
Seat 5: Crock361 (€1.74 in chips) 
Seat 6: father2008 (€2.15 in chips) 
TheMule1454: posts small blind €0.01
66lanci66: posts big blind €0.02
*** HOLE CARDS ***
Dealt to caduceus369 [Qh 3c]
2PaperelaSgubio: raises €0.03 to €0.05
Crock361: folds 
father2008: folds 
caduceus369: folds 
TheMule1454: folds 
66lanci66: folds 
Uncalled bet (€0.03) returned to 2PaperelaSgubio
2PaperelaSgubio collected €0.05 from pot
2PaperelaSgubio: doesn't show hand 
*** SUMMARY ***
Total pot €0.05 | Rake €0 
Seat 1: caduceus369 (button) folded before Flop (didn't bet)
Seat 2: TheMule1454 (small blind) folded before Flop
Seat 3: 66lanci66 (big blind) folded before Flop
Seat 4: 2PaperelaSgubio collected (€0.05)
Seat 5: Crock361 folded before Flop (didn't bet)
Seat 6: father2008 folded before Flop (didn't bet)



PokerStars Zoom Hand #258128744138:  Hold'em No Limit (€0.01/€0.02) [ADM ID: M62C63044C87BABT] - 2025/10/15 0:30:40 CET [2025/10/14 18:30:40 ET]
Table 'Sirio' 6-max Seat #1 is the button
Seat 1: caduceus369 (€3.41 in chips) 
Seat 2: Warterror90 (€4.26 in chips) 
Seat 3: colosso2022 (€6.12 in chips) 
Seat 4: Fraxasso (€4.41 in chips) 
Seat 5: ilteatro131 (€1.95 in chips) 
Seat 6: TheMule1454 (€1.16 in chips) 
Warterror90: posts small blind €0.01
colosso2022: posts big blind €0.02
*** HOLE CARDS ***
Dealt to caduceus369 [Qc Th]
Fraxasso: raises €0.02 to €0.04
ilteatro131: calls €0.04
colosso2022 is disconnected 
TheMule1454: calls €0.04
caduceus369: folds 
Warterror90: calls €0.03
colosso2022 has timed out while disconnected
colosso2022: folds 
*** FLOP *** [Jc 2d Js]
Warterror90: checks 
Fraxasso: checks 
ilteatro131: checks 
TheMule1454: checks 
*** TURN *** [Jc 2d Js] [6h]
Warterror90: bets €0.07
Fraxasso: calls €0.07
ilteatro131: folds 
TheMule1454: folds 
*** RIVER *** [Jc 2d Js 6h] [Ad]
Warterror90: checks 
Fraxasso: bets €0.10
Warterror90: calls €0.10
*** SHOW DOWN ***
Fraxasso: shows [Td Jd] (three of a kind, Jacks)
Warterror90: mucks hand 
Fraxasso collected €0.50 from pot
*** SUMMARY ***
Total pot €0.52 | Rake €0.02 
Board [Jc 2d Js 6h Ad]
Seat 1: caduceus369 (button) folded before Flop (didn't bet)
Seat 2: Warterror90 (small blind) mucked [5c 6c]
Seat 3: colosso2022 (big blind) folded before Flop
Seat 4: Fraxasso showed [Td Jd] and won (€0.50) with three of a kind, Jacks
Seat 5: ilteatro131 folded on the Turn
Seat 6: TheMule1454 folded on the Turn



PokerStars Zoom Hand #258128759958:  Hold'em No Limit (€0.01/€0.02) [ADM ID: M62C63044C87BABT] - 2025/10/15 0:31:58 CET [2025/10/14 18:31:58 ET]
Table 'Sirio' 6-max Seat #1 is the button
Seat 1: ADRIAN0_MEIS (€3.91 in chips) 
Seat 2: 2PaperelaSgubio (€2.09 in chips) 
Seat 3: aurelios2 (€10.76 in chips) 
Seat 4: McSup (€2.47 in chips) 
Seat 5: caduceus369 (€3.35 in chips) 
Seat 6: maury999999 (€7.27 in chips) 
2PaperelaSgubio: posts small blind €0.01
aurelios2: posts big blind €0.02
*** HOLE CARDS ***
Dealt to caduceus369 [8d Js]
McSup: folds 
caduceus369: folds 
maury999999: folds 
ADRIAN0_MEIS: folds 
2PaperelaSgubio: folds 
Uncalled bet (€0.01) returned to aurelios2
aurelios2 collected €0.02 from pot
aurelios2: doesn't show hand 
*** SUMMARY ***
Total pot €0.02 | Rake €0 
Seat 1: ADRIAN0_MEIS (button) folded before Flop (didn't bet)
Seat 2: 2PaperelaSgubio (small blind) folded before Flop
Seat 3: aurelios2 (big blind) collected (€0.02)
Seat 4: McSup folded before Flop (didn't bet)
Seat 5: caduceus369 folded before Flop (didn't bet)
Seat 6: maury999999 folded before Flop (didn't bet)



PokerStars Zoom Hand #258128760905:  Hold'em No Limit (€0.01/€0.02) [ADM ID: M62C63044C87BABT] - 2025/10/15 0:32:03 CET [2025/10/14 18:32:03 ET]
Table 'Sirio' 6-max Seat #1 is the button
Seat 1: BiscottinoXXL (€3.85 in chips) 
Seat 2: caduceus369 (€3.35 in chips) 
Seat 3: 2PaperelaSgubio (€2.66 in chips) 
Seat 4: maury999999 (€7.27 in chips) 
Seat 5: Warterror90 (€3.19 in chips) 
Seat 6: Fraxasso (€4.60 in chips) 
caduceus369: posts small blind €0.01
2PaperelaSgubio: posts big blind €0.02
*** HOLE CARDS ***
Dealt to caduceus369 [Td Qc]
maury999999: folds 
Warterror90: folds 
Fraxasso: raises €0.03 to €0.05
BiscottinoXXL: raises €0.11 to €0.16
caduceus369: folds 
2PaperelaSgubio: folds 
Fraxasso: folds 
Uncalled bet (€0.11) returned to BiscottinoXXL
BiscottinoXXL collected €0.13 from pot
BiscottinoXXL: doesn't show hand 
*** SUMMARY ***
Total pot €0.13 | Rake €0 
Seat 1: BiscottinoXXL (button) collected (€0.13)
Seat 2: caduceus369 (small blind) folded before Flop
Seat 3: 2PaperelaSgubio (big blind) folded before Flop
Seat 4: maury999999 folded before Flop (didn't bet)
Seat 5: Warterror90 folded before Flop (didn't bet)
Seat 6: Fraxasso folded before Flop



PokerStars Zoom Hand #258128763242:  Hold'em No Limit (€0.01/€0.02) [ADM ID: M62C63044C87BABT] - 2025/10/15 0:32:15 CET [2025/10/14 18:32:15 ET]
Table 'Sirio' 6-max Seat #1 is the button
Seat 1: aurelios2 (€10.77 in chips) 
Seat 2: Catania838 (€1.93 in chips) 
Seat 3: CarlaBBruni (€2.66 in chips) 
Seat 4: mashallahh (€2 in chips) 
Seat 5: pezz01 (€2 in chips) 
Seat 6: caduceus369 (€3.34 in chips) 
Catania838: posts small blind €0.01
CarlaBBruni: posts big blind €0.02
*** HOLE CARDS ***
Dealt to caduceus369 [7d 6h]
pezz01 is disconnected 
mashallahh: folds 
pezz01 has timed out while disconnected
pezz01: folds 
caduceus369: folds 
aurelios2: folds 
Catania838: folds 
Uncalled bet (€0.01) returned to CarlaBBruni
CarlaBBruni collected €0.02 from pot
CarlaBBruni: doesn't show hand 
*** SUMMARY ***
Total pot €0.02 | Rake €0 
Seat 1: aurelios2 (button) folded before Flop (didn't bet)
Seat 2: Catania838 (small blind) folded before Flop
Seat 3: CarlaBBruni (big blind) collected (€0.02)
Seat 4: mashallahh folded before Flop (didn't bet)
Seat 5: pezz01 folded before Flop (didn't bet)
Seat 6: caduceus369 folded before Flop (didn't bet)



PokerStars Zoom Hand #258128758341:  Hold'em No Limit (€0.01/€0.02) [ADM ID: M62C63044C87BABT] - 2025/10/15 0:31:50 CET [2025/10/14 18:31:50 ET]
Table 'Sirio' 6-max Seat #1 is the button
Seat 1: maury999999 (€7.27 in chips) 
Seat 2: mashallahh (€5.24 in chips) 
Seat 3: Crock361 (€2.34 in chips) 
Seat 4: BiscottinoXXL (€2 in chips) 
Seat 5: father2008 (€2.15 in chips) 
Seat 6: caduceus369 (€3.35 in chips) 
mashallahh: posts small blind €0.01
Crock361: posts big blind €0.02
*** HOLE CARDS ***
Dealt to caduceus369 [6h Qs]
BiscottinoXXL: folds 
father2008: raises €0.04 to €0.06
caduceus369: folds 
maury999999: folds 
mashallahh: calls €0.05
Crock361: folds 
*** FLOP *** [8c Qh Ks]
mashallahh: checks 
father2008: checks 
*** TURN *** [8c Qh Ks] [5h]
mashallahh: bets €0.10
father2008: folds 
Uncalled bet (€0.10) returned to mashallahh
mashallahh collected €0.14 from pot
mashallahh: doesn't show hand 
*** SUMMARY ***
Total pot €0.14 | Rake €0 
Board [8c Qh Ks 5h]
Seat 1: maury999999 (button) folded before Flop (didn't bet)
Seat 2: mashallahh (small blind) collected (€0.14)
Seat 3: Crock361 (big blind) folded before Flop
Seat 4: BiscottinoXXL folded before Flop (didn't bet)
Seat 5: father2008 folded on the Turn
Seat 6: caduceus369 folded before Flop (didn't bet)



PokerStars Zoom Hand #258128765567:  Hold'em No Limit (€0.01/€0.02) [ADM ID: M62C63044C87BABT] - 2025/10/15 0:32:26 CET [2025/10/14 18:32:26 ET]
Table 'Sirio' 6-max Seat #1 is the button
Seat 1: mashallahh (€2 in chips) 
Seat 2: TheMule1454 (€1.96 in chips) 
Seat 3: Fraxasso (€4.55 in chips) 
Seat 4: ADRIAN0_MEIS (€3.94 in chips) 
Seat 5: caduceus369 (€3.34 in chips) 
Seat 6: aurelios2 (€10.77 in chips) 
TheMule1454: posts small blind €0.01
Fraxasso: posts big blind €0.02
*** HOLE CARDS ***
Dealt to caduceus369 [Qh Jh]
ADRIAN0_MEIS: folds 
caduceus369: raises €0.04 to €0.06
aurelios2: folds 
mashallahh: raises €0.12 to €0.18
TheMule1454: folds 
Fraxasso: folds 
caduceus369: folds 
Uncalled bet (€0.12) returned to mashallahh
mashallahh collected €0.15 from pot
mashallahh: doesn't show hand 
*** SUMMARY ***
Total pot €0.15 | Rake €0 
Seat 1: mashallahh (button) collected (€0.15)
Seat 2: TheMule1454 (small blind) folded before Flop
Seat 3: Fraxasso (big blind) folded before Flop
Seat 4: ADRIAN0_MEIS folded before Flop (didn't bet)
Seat 5: caduceus369 folded before Flop
Seat 6: aurelios2 folded before Flop (didn't bet)



PokerStars Zoom Hand #258128771128:  Hold'em No Limit (€0.01/€0.02) [ADM ID: M62C63044C87BABT] - 2025/10/15 0:32:54 CET [2025/10/14 18:32:54 ET]
Table 'Sirio' 6-max Seat #1 is the button
Seat 1: caduceus369 (€3.28 in chips) 
Seat 2: Catania838 (€1.94 in chips) 
Seat 3: fragolone100 (€0.58 in chips) 
Seat 4: Begimon (€12.46 in chips) 
Seat 5: BiscottinoXXL (€3.96 in chips) 
Seat 6: CarlaBBruni (€2.67 in chips) 
Catania838: posts small blind €0.01
fragolone100: posts big blind €0.02
*** HOLE CARDS ***
Dealt to caduceus369 [5s Jd]
Begimon: folds 
BiscottinoXXL: folds 
CarlaBBruni: folds 
caduceus369: folds 
Catania838: folds 
Uncalled bet (€0.01) returned to fragolone100
fragolone100 collected €0.02 from pot
fragolone100: doesn't show hand 
*** SUMMARY ***
Total pot €0.02 | Rake €0 
Seat 1: caduceus369 (button) folded before Flop (didn't bet)
Seat 2: Catania838 (small blind) folded before Flop
Seat 3: fragolone100 (big blind) collected (€0.02)
Seat 4: Begimon folded before Flop (didn't bet)
Seat 5: BiscottinoXXL folded before Flop (didn't bet)
Seat 6: CarlaBBruni folded before Flop (didn't bet)



PokerStars Zoom Hand #258128772469:  Hold'em No Limit (€0.01/€0.02) [ADM ID: M62C63044C87BABT] - 2025/10/15 0:33:01 CET [2025/10/14 18:33:01 ET]
Table 'Sirio' 6-max Seat #1 is the button
Seat 1: CarlaBBruni (€2.42 in chips) 
Seat 2: Begimon (€12.46 in chips) 
Seat 3: caduceus369 (€3.28 in chips) 
Seat 4: mashallahh (€7.54 in chips) 
Seat 5: bv0360 (€0.54 in chips) 
Seat 6: Fraxasso (€4.67 in chips) 
Begimon: posts small blind €0.01
caduceus369: posts big blind €0.02
*** HOLE CARDS ***
Dealt to caduceus369 [5c Th]
mashallahh: folds 
bv0360: calls €0.02
Fraxasso: folds 
CarlaBBruni: calls €0.02
Begimon: calls €0.01
caduceus369: checks 
*** FLOP *** [3c Td Kc]
Begimon: bets €0.02
caduceus369: folds 
bv0360: calls €0.02
CarlaBBruni: folds 
*** TURN *** [3c Td Kc] [3s]
Begimon: bets €0.02
bv0360: calls €0.02
*** RIVER *** [3c Td Kc 3s] [6h]
Begimon: bets €0.02
bv0360: calls €0.02
*** SHOW DOWN ***
Begimon: shows [Ts Qh] (two pair, Tens and Threes)
bv0360: mucks hand 
Begimon collected €0.19 from pot
*** SUMMARY ***
Total pot €0.20 | Rake €0.01 
Board [3c Td Kc 3s 6h]
Seat 1: CarlaBBruni (button) folded on the Flop
Seat 2: Begimon (small blind) showed [Ts Qh] and won (€0.19) with two pair, Tens and Threes
Seat 3: caduceus369 (big blind) folded on the Flop
Seat 4: mashallahh folded before Flop (didn't bet)
Seat 5: bv0360 mucked [Ah 4d]
Seat 6: Fraxasso folded before Flop (didn't bet)



PokerStars Zoom Hand #258128779592:  Hold'em No Limit (€0.01/€0.02) [ADM ID: M62C63044C87BABT] - 2025/10/15 0:33:37 CET [2025/10/14 18:33:37 ET]
Table 'Sirio' 6-max Seat #1 is the button
Seat 1: TheMule1454 (€1.54 in chips) 
Seat 2: Warterror90 (€4.14 in chips) 
Seat 3: mashallahh (€7.54 in chips) 
Seat 4: caduceus369 (€3.26 in chips) 
Seat 5: maury999999 (€4.42 in chips) 
Seat 6: Fraxasso (€4.67 in chips) 
Warterror90: posts small blind €0.01
mashallahh: posts big blind €0.02
*** HOLE CARDS ***
Dealt to caduceus369 [Kh Qd]
caduceus369: raises €0.04 to €0.06
maury999999: folds 
Fraxasso: folds 
TheMule1454: folds 
Warterror90: raises €0.12 to €0.18
mashallahh: folds 
caduceus369: calls €0.12
*** FLOP *** [2s 4s 4h]
Warterror90: bets €0.14
caduceus369: folds 
Uncalled bet (€0.14) returned to Warterror90
Warterror90 collected €0.36 from pot
Warterror90: doesn't show hand 
*** SUMMARY ***
Total pot €0.38 | Rake €0.02 
Board [2s 4s 4h]
Seat 1: TheMule1454 (button) folded before Flop (didn't bet)
Seat 2: Warterror90 (small blind) collected (€0.36)
Seat 3: mashallahh (big blind) folded before Flop
Seat 4: caduceus369 folded on the Flop
Seat 5: maury999999 folded before Flop (didn't bet)
Seat 6: Fraxasso folded before Flop (didn't bet)



PokerStars Zoom Hand #258128785332:  Hold'em No Limit (€0.01/€0.02) [ADM ID: M62C63044C87BABT] - 2025/10/15 0:34:05 CET [2025/10/14 18:34:05 ET]
Table 'Sirio' 6-max Seat #1 is the button
Seat 1: father2008 (€2.24 in chips) 
Seat 2: caduceus369 (€3.08 in chips) 
Seat 3: Crock361 (€1.92 in chips) 
Seat 4: Catania838 (€1.87 in chips) 
Seat 5: maury999999 (€7.55 in chips) 
Seat 6: talpa890 (€2.47 in chips) 
caduceus369: posts small blind €0.01
Crock361: posts big blind €0.02
*** HOLE CARDS ***
Dealt to caduceus369 [5h 3s]
Catania838: calls €0.02
maury999999: raises €0.06 to €0.08
talpa890: folds 
father2008: folds 
caduceus369: folds 
Crock361: folds 
Catania838: calls €0.06
*** FLOP *** [As Tc Th]
Catania838: checks 
maury999999: bets €0.06
Catania838: raises €0.06 to €0.12
maury999999: calls €0.06
*** TURN *** [As Tc Th] [Ts]
Catania838: bets €1.67 and is all-in
maury999999: folds 
Uncalled bet (€1.67) returned to Catania838
Catania838 collected €0.41 from pot
Catania838: doesn't show hand 
*** SUMMARY ***
Total pot €0.43 | Rake €0.02 
Board [As Tc Th Ts]
Seat 1: father2008 (button) folded before Flop (didn't bet)
Seat 2: caduceus369 (small blind) folded before Flop
Seat 3: Crock361 (big blind) folded before Flop
Seat 4: Catania838 collected (€0.41)
Seat 5: maury999999 folded on the Turn
Seat 6: talpa890 folded before Flop (didn't bet)



PokerStars Zoom Hand #258128794300:  Hold'em No Limit (€0.01/€0.02) [ADM ID: M62C63044C87BABT] - 2025/10/15 0:34:50 CET [2025/10/14 18:34:50 ET]
Table 'Sirio' 6-max Seat #1 is the button
Seat 1: mangiafocos (€2 in chips) 
Seat 2: McSup (€2.03 in chips) 
Seat 3: 2PaperelaSgubio (€3.06 in chips) 
Seat 4: caduceus369 (€3.07 in chips) 
Seat 5: 66lanci66 (€1.84 in chips) 
Seat 6: mashallahh (€7.51 in chips) 
McSup: posts small blind €0.01
2PaperelaSgubio: posts big blind €0.02
*** HOLE CARDS ***
Dealt to caduceus369 [9h Kc]
caduceus369: folds 
66lanci66: folds 
mashallahh: folds 
mangiafocos: folds 
McSup: calls €0.01
2PaperelaSgubio: raises €0.06 to €0.08
McSup: folds 
Uncalled bet (€0.06) returned to 2PaperelaSgubio
2PaperelaSgubio collected €0.04 from pot
2PaperelaSgubio: doesn't show hand 
*** SUMMARY ***
Total pot €0.04 | Rake €0 
Seat 1: mangiafocos (button) folded before Flop (didn't bet)
Seat 2: McSup (small blind) folded before Flop
Seat 3: 2PaperelaSgubio (big blind) collected (€0.04)
Seat 4: caduceus369 folded before Flop (didn't bet)
Seat 5: 66lanci66 folded before Flop (didn't bet)
Seat 6: mashallahh folded before Flop (didn't bet)



PokerStars Zoom Hand #258128795765:  Hold'em No Limit (€0.01/€0.02) [ADM ID: M62C63044C87BABT] - 2025/10/15 0:34:57 CET [2025/10/14 18:34:57 ET]
Table 'Sirio' 6-max Seat #1 is the button
Seat 1: caduceus369 (€3.07 in chips) 
Seat 2: Crock361 (€1.96 in chips) 
Seat 3: CarlaBBruni (€2.14 in chips) 
Seat 4: BiscottinoXXL (€3.78 in chips) 
Seat 5: TheMule1454 (€3.09 in chips) 
Seat 6: Agnese84 (€2.37 in chips) 
Crock361: posts small blind €0.01
CarlaBBruni: posts big blind €0.02
*** HOLE CARDS ***
Dealt to caduceus369 [9s 2c]
BiscottinoXXL: folds 
TheMule1454: folds 
Agnese84: raises €0.06 to €0.08
caduceus369: folds 
Crock361: folds 
CarlaBBruni: calls €0.06
*** FLOP *** [5h 5d Qd]
CarlaBBruni: checks 
Agnese84: bets €0.09
CarlaBBruni: folds 
Uncalled bet (€0.09) returned to Agnese84
Agnese84 collected €0.17 from pot
Agnese84: doesn't show hand 
*** SUMMARY ***
Total pot €0.17 | Rake €0 
Board [5h 5d Qd]
Seat 1: caduceus369 (button) folded before Flop (didn't bet)
Seat 2: Crock361 (small blind) folded before Flop
Seat 3: CarlaBBruni (big blind) folded on the Flop
Seat 4: BiscottinoXXL folded before Flop (didn't bet)
Seat 5: TheMule1454 folded before Flop (didn't bet)
Seat 6: Agnese84 collected (€0.17)



PokerStars Zoom Hand #258128792732:  Hold'em No Limit (€0.01/€0.02) [ADM ID: M62C63044C87BABT] - 2025/10/15 0:34:42 CET [2025/10/14 18:34:42 ET]
Table 'Sirio' 6-max Seat #1 is the button
Seat 1: Warterror90 (€3.66 in chips) 
Seat 2: TheMule1454 (€3.10 in chips) 
Seat 3: Crock361 (€2.22 in chips) 
Seat 4: father2008 (€2.23 in chips) 
Seat 5: McSup (€2.03 in chips) 
Seat 6: caduceus369 (€3.07 in chips) 
TheMule1454: posts small blind €0.01
Crock361: posts big blind €0.02
*** HOLE CARDS ***
Dealt to caduceus369 [9s Ts]
father2008: folds 
McSup: folds 
caduceus369: folds 
Warterror90: raises €0.04 to €0.06
TheMule1454: folds 
Crock361: calls €0.04
*** FLOP *** [Td 5s Jc]
Crock361: checks 
Warterror90: bets €0.05
Crock361: calls €0.05
*** TURN *** [Td 5s Jc] [Js]
Crock361: checks 
Warterror90: checks 
*** RIVER *** [Td 5s Jc Js] [6c]
Crock361: bets €0.32
Warterror90: folds 
Uncalled bet (€0.32) returned to Crock361
Crock361 collected €0.22 from pot
Crock361: doesn't show hand 
*** SUMMARY ***
Total pot €0.23 | Rake €0.01 
Board [Td 5s Jc Js 6c]
Seat 1: Warterror90 (button) folded on the River
Seat 2: TheMule1454 (small blind) folded before Flop
Seat 3: Crock361 (big blind) collected (€0.22)
Seat 4: father2008 folded before Flop (didn't bet)
Seat 5: McSup folded before Flop (didn't bet)
Seat 6: caduceus369 folded before Flop (didn't bet)



PokerStars Zoom Hand #258128802569:  Hold'em No Limit (€0.01/€0.02) [ADM ID: M62C63044C87BABT] - 2025/10/15 0:35:31 CET [2025/10/14 18:35:31 ET]
Table 'Sirio' 6-max Seat #1 is the button
Seat 1: Catania838 (€2.09 in chips) 
Seat 2: caduceus369 (€3.05 in chips) 
Seat 3: CIKO71131 (€0.41 in chips) 
Seat 4: father2008 (€2.31 in chips) 
Seat 5: 2PaperelaSgubio (€3.08 in chips) 
Seat 6: CarlaBBruni (€3 in chips) 
caduceus369: posts small blind €0.01
CIKO71131: posts big blind €0.02
*** HOLE CARDS ***
Dealt to caduceus369 [4h Qh]
father2008: folds 
2PaperelaSgubio: folds 
CarlaBBruni: raises €0.03 to €0.05
Catania838: folds 
caduceus369: folds 
CIKO71131: calls €0.03
*** FLOP *** [Kc 3h Kh]
CIKO71131: checks 
CarlaBBruni: checks 
*** TURN *** [Kc 3h Kh] [3s]
CIKO71131: checks 
CarlaBBruni: bets €0.02
CIKO71131: calls €0.02
*** RIVER *** [Kc 3h Kh 3s] [3c]
CIKO71131: checks 
CarlaBBruni: bets €0.13
CIKO71131: calls €0.13
*** SHOW DOWN ***
CarlaBBruni: shows [Ks 7s] (a full house, Kings full of Threes)
CIKO71131: mucks hand 
CarlaBBruni collected €0.39 from pot
*** SUMMARY ***
Total pot €0.41 | Rake €0.02 
Board [Kc 3h Kh 3s 3c]
Seat 1: Catania838 (button) folded before Flop (didn't bet)
Seat 2: caduceus369 (small blind) folded before Flop
Seat 3: CIKO71131 (big blind) mucked [Qc Qd]
Seat 4: father2008 folded before Flop (didn't bet)
Seat 5: 2PaperelaSgubio folded before Flop (didn't bet)
Seat 6: CarlaBBruni showed [Ks 7s] and won (€0.39) with a full house, Kings full of Threes



PokerStars Zoom Hand #258128797224:  Hold'em No Limit (€0.01/€0.02) [ADM ID: M62C63044C87BABT] - 2025/10/15 0:35:05 CET [2025/10/14 18:35:05 ET]
Table 'Sirio' 6-max Seat #1 is the button
Seat 1: meteco79 (€1.33 in chips) 
Seat 2: 2PaperelaSgubio (€1.99 in chips) 
Seat 3: caduceus369 (€3.07 in chips) 
Seat 4: Catania838 (€2.12 in chips) 
Seat 5: BiscottinoXXL (€3.78 in chips) 
Seat 6: This Heat (€1.55 in chips) 
2PaperelaSgubio: posts small blind €0.01
caduceus369: posts big blind €0.02
*** HOLE CARDS ***
Dealt to caduceus369 [Jc 5c]
Catania838: folds 
BiscottinoXXL has timed out
BiscottinoXXL: folds 
This Heat: raises €0.04 to €0.06
meteco79: folds 
2PaperelaSgubio: calls €0.05
caduceus369: folds 
*** FLOP *** [9c 6c As]
2PaperelaSgubio: checks 
This Heat: bets €0.08
2PaperelaSgubio: calls €0.08
*** TURN *** [9c 6c As] [Ks]
2PaperelaSgubio: checks 
This Heat: bets €0.15
2PaperelaSgubio: calls €0.15
*** RIVER *** [9c 6c As Ks] [8h]
2PaperelaSgubio: checks 
This Heat: bets €0.29
2PaperelaSgubio: folds 
Uncalled bet (€0.29) returned to This Heat
This Heat collected €0.57 from pot
This Heat: doesn't show hand 
*** SUMMARY ***
Total pot €0.60 | Rake €0.03 
Board [9c 6c As Ks 8h]
Seat 1: meteco79 (button) folded before Flop (didn't bet)
Seat 2: 2PaperelaSgubio (small blind) folded on the River
Seat 3: caduceus369 (big blind) folded before Flop
Seat 4: Catania838 folded before Flop (didn't bet)
Seat 5: BiscottinoXXL folded before Flop (didn't bet)
Seat 6: This Heat collected (€0.57)



PokerStars Zoom Hand #258128804418:  Hold'em No Limit (€0.01/€0.02) [ADM ID: M62C63044C87BABT] - 2025/10/15 0:35:41 CET [2025/10/14 18:35:41 ET]
Table 'Sirio' 6-max Seat #1 is the button
Seat 1: Crock361 (€2.33 in chips) 
Seat 2: BiscottinoXXL (€4.24 in chips) 
Seat 3: Warterror90 (€3.32 in chips) 
Seat 4: meteco79 (€1.32 in chips) 
Seat 5: maury999999 (€4.47 in chips) 
Seat 6: caduceus369 (€3.04 in chips) 
BiscottinoXXL: posts small blind €0.01
Warterror90: posts big blind €0.02
*** HOLE CARDS ***
Dealt to caduceus369 [4c 3c]
meteco79: calls €0.02
maury999999: raises €0.06 to €0.08
caduceus369: folds 
Crock361: folds 
BiscottinoXXL: folds 
Warterror90: folds 
meteco79: calls €0.06
*** FLOP *** [Kh Ks 7s]
meteco79: checks 
maury999999: checks 
*** TURN *** [Kh Ks 7s] [Js]
meteco79: bets €1.24 and is all-in
maury999999: folds 
Uncalled bet (€1.24) returned to meteco79
meteco79 collected €0.18 from pot
meteco79: doesn't show hand 
*** SUMMARY ***
Total pot €0.19 | Rake €0.01 
Board [Kh Ks 7s Js]
Seat 1: Crock361 (button) folded before Flop (didn't bet)
Seat 2: BiscottinoXXL (small blind) folded before Flop
Seat 3: Warterror90 (big blind) folded before Flop
Seat 4: meteco79 collected (€0.18)
Seat 5: maury999999 folded on the Turn
Seat 6: caduceus369 folded before Flop (didn't bet)



PokerStars Zoom Hand #258128807279:  Hold'em No Limit (€0.01/€0.02) [ADM ID: M62C63044C87BABT] - 2025/10/15 0:35:55 CET [2025/10/14 18:35:55 ET]
Table 'Sirio' 6-max Seat #1 is the button
Seat 1: Crock361 (€1.95 in chips) 
Seat 2: father2008 (€2.31 in chips) 
Seat 3: maury999999 (€7.31 in chips) 
Seat 4: TheMule1454 (€1.53 in chips) 
Seat 5: caduceus369 (€3.04 in chips) 
Seat 6: ilteatro131 (€2.19 in chips) 
father2008: posts small blind €0.01
maury999999: posts big blind €0.02
*** HOLE CARDS ***
Dealt to caduceus369 [As Qh]
TheMule1454: raises €0.02 to €0.04
caduceus369: raises €0.10 to €0.14
ilteatro131: folds 
Crock361: folds 
father2008: folds 
maury999999: folds 
TheMule1454: calls €0.10
*** FLOP *** [4s 6h 7h]
TheMule1454: bets €0.15
caduceus369: folds 
Uncalled bet (€0.15) returned to TheMule1454
TheMule1454 collected €0.30 from pot
TheMule1454: doesn't show hand 
*** SUMMARY ***
Total pot €0.31 | Rake €0.01 
Board [4s 6h 7h]
Seat 1: Crock361 (button) folded before Flop (didn't bet)
Seat 2: father2008 (small blind) folded before Flop
Seat 3: maury999999 (big blind) folded before Flop
Seat 4: TheMule1454 collected (€0.30)
Seat 5: caduceus369 folded on the Flop
Seat 6: ilteatro131 folded before Flop (didn't bet)



PokerStars Zoom Hand #258128806152:  Hold'em No Limit (€0.01/€0.02) [ADM ID: M62C63044C87BABT] - 2025/10/15 0:35:49 CET [2025/10/14 18:35:49 ET]
Table 'Sirio' 6-max Seat #1 is the button
Seat 1: talpa890 (€2.50 in chips) 
Seat 2: Catania838 (€2.09 in chips) 
Seat 3: mangiafocos (€2 in chips) 
Seat 4: McSup (€2.02 in chips) 
Seat 5: caduceus369 (€3.04 in chips) 
Seat 6: Vitto oolin (€0.83 in chips) 
Catania838: posts small blind €0.01
mangiafocos: posts big blind €0.02
*** HOLE CARDS ***
Dealt to caduceus369 [2d Js]
McSup: raises €0.04 to €0.06
caduceus369: folds 
Vitto oolin: calls €0.06
talpa890: folds 
Catania838: folds 
mangiafocos: raises €0.12 to €0.18
McSup: calls €0.12
Vitto oolin: folds 
*** FLOP *** [Kc Th 3s]
mangiafocos: bets €0.35
McSup: calls €0.35
*** TURN *** [Kc Th 3s] [8h]
mangiafocos: bets €1.47 and is all-in
McSup: calls €1.47
*** RIVER *** [Kc Th 3s 8h] [9d]
*** SHOW DOWN ***
mangiafocos: shows [Jc Ad] (high card Ace)
McSup: shows [Ks Kd] (three of a kind, Kings)
McSup collected €3.85 from pot
mangiafocos is disconnected 
*** SUMMARY ***
Total pot €4.07 | Rake €0.22 
Board [Kc Th 3s 8h 9d]
Seat 1: talpa890 (button) folded before Flop (didn't bet)
Seat 2: Catania838 (small blind) folded before Flop
Seat 3: mangiafocos (big blind) showed [Jc Ad] and lost with high card Ace
Seat 4: McSup showed [Ks Kd] and won (€3.85) with three of a kind, Kings
Seat 5: caduceus369 folded before Flop (didn't bet)
Seat 6: Vitto oolin folded before Flop



PokerStars Zoom Hand #258128819856:  Hold'em No Limit (€0.01/€0.02) [ADM ID: M62C63044C87BABT] - 2025/10/15 0:36:58 CET [2025/10/14 18:36:58 ET]
Table 'Sirio' 6-max Seat #1 is the button
Seat 1: maury999999 (€4.37 in chips) 
Seat 2: BiscottinoXXL (€3.73 in chips) 
Seat 3: McSup (€3.87 in chips) 
Seat 4: CIKO71131 (€0.42 in chips) 
Seat 5: CarlaBBruni (€3.45 in chips) 
Seat 6: caduceus369 (€2.87 in chips) 
BiscottinoXXL: posts small blind €0.01
McSup: posts big blind €0.02
*** HOLE CARDS ***
Dealt to caduceus369 [9c Kh]
CIKO71131: folds 
CarlaBBruni: folds 
caduceus369: folds 
maury999999: folds 
BiscottinoXXL: raises €0.04 to €0.06
McSup: folds 
Uncalled bet (€0.04) returned to BiscottinoXXL
BiscottinoXXL collected €0.04 from pot
BiscottinoXXL: doesn't show hand 
*** SUMMARY ***
Total pot €0.04 | Rake €0 
Seat 1: maury999999 (button) folded before Flop (didn't bet)
Seat 2: BiscottinoXXL (small blind) collected (€0.04)
Seat 3: McSup (big blind) folded before Flop
Seat 4: CIKO71131 folded before Flop (didn't bet)
Seat 5: CarlaBBruni folded before Flop (didn't bet)
Seat 6: caduceus369 folded before Flop (didn't bet)



PokerStars Zoom Hand #258128814674:  Hold'em No Limit (€0.01/€0.02) [ADM ID: M62C63044C87BABT] - 2025/10/15 0:36:32 CET [2025/10/14 18:36:32 ET]
Table 'Sirio' 6-max Seat #1 is the button
Seat 1: aurelios2 (€10.07 in chips) 
Seat 2: TheMule1454 (€1.98 in chips) 
Seat 3: caduceus369 (€2.90 in chips) 
Seat 4: mashallahh (€7.39 in chips) 
Seat 5: Vitto oolin (€0.77 in chips) 
Seat 6: This Heat (€1.85 in chips) 
TheMule1454: posts small blind €0.01
caduceus369: posts big blind €0.02
*** HOLE CARDS ***
Dealt to caduceus369 [9h 2c]
mashallahh: raises €0.04 to €0.06
Vitto oolin: folds 
This Heat: calls €0.06
aurelios2: folds 
TheMule1454: folds 
caduceus369: folds 
*** FLOP *** [Ad Kh 6d]
mashallahh: bets €0.11
This Heat: calls €0.11
*** TURN *** [Ad Kh 6d] [Qc]
mashallahh: bets €0.25
This Heat: calls €0.25
*** RIVER *** [Ad Kh 6d Qc] [6h]
mashallahh: bets €0.57
This Heat: calls €0.57
*** SHOW DOWN ***
mashallahh: shows [Qd As] (two pair, Aces and Queens)
This Heat: mucks hand 
mashallahh collected €1.90 from pot
*** SUMMARY ***
Total pot €2.01 | Rake €0.11 
Board [Ad Kh 6d Qc 6h]
Seat 1: aurelios2 (button) folded before Flop (didn't bet)
Seat 2: TheMule1454 (small blind) folded before Flop
Seat 3: caduceus369 (big blind) folded before Flop
Seat 4: mashallahh showed [Qd As] and won (€1.90) with two pair, Aces and Queens
Seat 5: Vitto oolin folded before Flop (didn't bet)
Seat 6: This Heat mucked [5d Ah]



PokerStars Zoom Hand #258128817775:  Hold'em No Limit (€0.01/€0.02) [ADM ID: M62C63044C87BABT] - 2025/10/15 0:36:47 CET [2025/10/14 18:36:47 ET]
Table 'Sirio' 6-max Seat #1 is the button
Seat 1: caduceus369 (€2.87 in chips) 
Seat 2: CIKO71131 (€0.43 in chips) 
Seat 3: Crock361 (€2.17 in chips) 
Seat 4: Warterror90 (€4.47 in chips) 
Seat 5: ilteatro131 (€2.17 in chips) 
Seat 6: talpa890 (€1.90 in chips) 
CIKO71131: posts small blind €0.01
Crock361: posts big blind €0.02
*** HOLE CARDS ***
Dealt to caduceus369 [6d Qc]
Warterror90: folds 
ilteatro131: calls €0.02
talpa890: calls €0.02
caduceus369: folds 
CIKO71131: folds 
Crock361: checks 
*** FLOP *** [7s Kh Ah]
Crock361: checks 
ilteatro131: bets €0.02
talpa890: calls €0.02
Crock361: folds 
*** TURN *** [7s Kh Ah] [3s]
ilteatro131: bets €0.11
talpa890: folds 
Uncalled bet (€0.11) returned to ilteatro131
ilteatro131 collected €0.11 from pot
ilteatro131: doesn't show hand 
*** SUMMARY ***
Total pot €0.11 | Rake €0 
Board [7s Kh Ah 3s]
Seat 1: caduceus369 (button) folded before Flop (didn't bet)
Seat 2: CIKO71131 (small blind) folded before Flop
Seat 3: Crock361 (big blind) folded on the Flop
Seat 4: Warterror90 folded before Flop (didn't bet)
Seat 5: ilteatro131 collected (€0.11)
Seat 6: talpa890 folded on the Turn



PokerStars Zoom Hand #258128821616:  Hold'em No Limit (€0.01/€0.02) [ADM ID: M62C63044C87BABT] - 2025/10/15 0:37:07 CET [2025/10/14 18:37:07 ET]
Table 'Sirio' 6-max Seat #1 is the button
Seat 1: father2008 (€2.24 in chips) 
Seat 2: Crock361 (€1.93 in chips) 
Seat 3: fragolone100 (€1.02 in chips) 
Seat 4: CarlaBBruni (€3.45 in chips) 
Seat 5: caduceus369 (€2.87 in chips) 
Seat 6: CIKO71131 (€0.42 in chips) 
Crock361: posts small blind €0.01
fragolone100: posts big blind €0.02
*** HOLE CARDS ***
Dealt to caduceus369 [Jc 9d]
CarlaBBruni: folds 
caduceus369: folds 
CIKO71131: folds 
father2008: raises €0.04 to €0.06
Crock361: folds 
fragolone100: calls €0.04
*** FLOP *** [4s As 8d]
fragolone100: checks 
father2008: checks 
*** TURN *** [4s As 8d] [Kd]
fragolone100: checks 
father2008: checks 
*** RIVER *** [4s As 8d Kd] [2c]
fragolone100: checks 
father2008: checks 
*** SHOW DOWN ***
fragolone100: shows [Js Qd] (high card Ace)
father2008: mucks hand 
fragolone100 collected €0.13 from pot
*** SUMMARY ***
Total pot €0.13 | Rake €0 
Board [4s As 8d Kd 2c]
Seat 1: father2008 (button) mucked [6c 9c]
Seat 2: Crock361 (small blind) folded before Flop
Seat 3: fragolone100 (big blind) showed [Js Qd] and won (€0.13) with high card Ace
Seat 4: CarlaBBruni folded before Flop (didn't bet)
Seat 5: caduceus369 folded before Flop (didn't bet)
Seat 6: CIKO71131 folded before Flop (didn't bet)



PokerStars Zoom Hand #258128826300:  Hold'em No Limit (€0.01/€0.02) [ADM ID: M62C63044C87BABT] - 2025/10/15 0:37:30 CET [2025/10/14 18:37:30 ET]
Table 'Sirio' 6-max Seat #1 is the button
Seat 1: Warterror90 (€3.32 in chips) 
Seat 2: Crock361 (€2.15 in chips) 
Seat 3: CarlaBBruni (€1.89 in chips) 
Seat 4: caduceus369 (€2.87 in chips) 
Seat 5: ilteatro131 (€2.24 in chips) 
Seat 6: BiscottinoXXL (€3.75 in chips) 
Crock361: posts small blind €0.01
CarlaBBruni: posts big blind €0.02
*** HOLE CARDS ***
Dealt to caduceus369 [Jh Jd]
caduceus369: raises €0.04 to €0.06
ilteatro131: folds 
BiscottinoXXL: folds 
Warterror90: folds 
Crock361: folds 
CarlaBBruni: folds 
Uncalled bet (€0.04) returned to caduceus369
caduceus369 collected €0.05 from pot
caduceus369: doesn't show hand 
*** SUMMARY ***
Total pot €0.05 | Rake €0 
Seat 1: Warterror90 (button) folded before Flop (didn't bet)
Seat 2: Crock361 (small blind) folded before Flop
Seat 3: CarlaBBruni (big blind) folded before Flop
Seat 4: caduceus369 collected (€0.05)
Seat 5: ilteatro131 folded before Flop (didn't bet)
Seat 6: BiscottinoXXL folded before Flop (didn't bet)



PokerStars Zoom Hand #258128816714:  Hold'em No Limit (€0.01/€0.02) [ADM ID: M62C63044C87BABT] - 2025/10/15 0:36:42 CET [2025/10/14 18:36:42 ET]
Table 'Sirio' 6-max Seat #1 is the button
Seat 1: ilteatro131 (€2.17 in chips) 
Seat 2: caduceus369 (€2.88 in chips) 
Seat 3: mashallahh (€2.65 in chips) 
Seat 4: Crock361 (€2.17 in chips) 
Seat 5: Alifatti (€0.75 in chips) 
Seat 6: TheMule1454 (€1.97 in chips) 
caduceus369: posts small blind €0.01
mashallahh: posts big blind €0.02
*** HOLE CARDS ***
Dealt to caduceus369 [6h 2h]
Crock361: folds 
Alifatti: calls €0.02
TheMule1454: raises €0.02 to €0.04
ilteatro131: folds 
caduceus369: folds 
mashallahh: folds 
Alifatti: calls €0.02
*** FLOP *** [Qd 7d Jc]
Alifatti: checks 
TheMule1454: checks 
*** TURN *** [Qd 7d Jc] [Ac]
Alifatti: checks 
TheMule1454: checks 
*** RIVER *** [Qd 7d Jc Ac] [4c]
Alifatti: checks 
TheMule1454: checks 
*** SHOW DOWN ***
Alifatti: shows [5s Ks] (high card Ace)
TheMule1454: shows [Kc Jh] (a pair of Jacks)
TheMule1454 collected €0.11 from pot
*** SUMMARY ***
Total pot €0.11 | Rake €0 
Board [Qd 7d Jc Ac 4c]
Seat 1: ilteatro131 (button) folded before Flop (didn't bet)
Seat 2: caduceus369 (small blind) folded before Flop
Seat 3: mashallahh (big blind) folded before Flop
Seat 4: Crock361 folded before Flop (didn't bet)
Seat 5: Alifatti showed [5s Ks] and lost with high card Ace
Seat 6: TheMule1454 showed [Kc Jh] and won (€0.11) with a pair of Jacks



PokerStars Zoom Hand #258128825067:  Hold'em No Limit (€0.01/€0.02) [ADM ID: M62C63044C87BABT] - 2025/10/15 0:37:24 CET [2025/10/14 18:37:24 ET]
Table 'Sirio' 6-max Seat #1 is the button
Seat 1: bv0360 (€1.44 in chips) 
Seat 2: maury999999 (€4.37 in chips) 
Seat 3: McSup (€2.25 in chips) 
Seat 4: caduceus369 (€2.87 in chips) 
Seat 5: CarlaBBruni (€1.89 in chips) 
Seat 6: Crock361 (€2.15 in chips) 
maury999999: posts small blind €0.01
McSup: posts big blind €0.02
*** HOLE CARDS ***
Dealt to caduceus369 [5c Kc]
caduceus369: folds 
CarlaBBruni: folds 
Crock361: folds 
bv0360: calls €0.02
maury999999: folds 
McSup: checks 
*** FLOP *** [3h 2d 2h]
McSup: checks 
bv0360: checks 
*** TURN *** [3h 2d 2h] [5h]
McSup: checks 
bv0360: checks 
*** RIVER *** [3h 2d 2h 5h] [2s]
McSup: checks 
bv0360: checks 
*** SHOW DOWN ***
McSup: shows [Qh Ts] (three of a kind, Deuces)
bv0360: mucks hand 
McSup collected €0.05 from pot
*** SUMMARY ***
Total pot €0.05 | Rake €0 
Board [3h 2d 2h 5h 2s]
Seat 1: bv0360 (button) mucked [8s Jh]
Seat 2: maury999999 (small blind) folded before Flop
Seat 3: McSup (big blind) showed [Qh Ts] and won (€0.05) with three of a kind, Deuces
Seat 4: caduceus369 folded before Flop (didn't bet)
Seat 5: CarlaBBruni folded before Flop (didn't bet)
Seat 6: Crock361 folded before Flop (didn't bet)



PokerStars Zoom Hand #258128822686:  Hold'em No Limit (€0.01/€0.02) [ADM ID: M62C63044C87BABT] - 2025/10/15 0:37:12 CET [2025/10/14 18:37:12 ET]
Table 'Sirio' 6-max Seat #1 is the button
Seat 1: caduceus369 (€2.87 in chips) 
Seat 2: maury999999 (€7.31 in chips) 
Seat 3: Freddy15081988 (€1.95 in chips) 
Seat 4: toscano31 (€3.03 in chips) 
Seat 5: TheMule1454 (€1.67 in chips) 
Seat 6: McSup (€3.85 in chips) 
maury999999: posts small blind €0.01
Freddy15081988: posts big blind €0.02
*** HOLE CARDS ***
Dealt to caduceus369 [Kh 5d]
toscano31: raises €0.02 to €0.04
TheMule1454: folds 
McSup: calls €0.04
caduceus369: folds 
maury999999: raises €0.20 to €0.24
Freddy15081988: folds 
toscano31: calls €0.20
McSup: folds 
*** FLOP *** [4d Qs 5c]
maury999999: checks 
toscano31: checks 
*** TURN *** [4d Qs 5c] [Qd]
maury999999: bets €0.17
toscano31: calls €0.17
*** RIVER *** [4d Qs 5c Qd] [4s]
maury999999: bets €0.28
toscano31: folds 
Uncalled bet (€0.28) returned to maury999999
maury999999 collected €0.84 from pot
maury999999: doesn't show hand 
*** SUMMARY ***
Total pot €0.88 | Rake €0.04 
Board [4d Qs 5c Qd 4s]
Seat 1: caduceus369 (button) folded before Flop (didn't bet)
Seat 2: maury999999 (small blind) collected (€0.84)
Seat 3: Freddy15081988 (big blind) folded before Flop
Seat 4: toscano31 folded on the River
Seat 5: TheMule1454 folded before Flop (didn't bet)
Seat 6: McSup folded before Flop



PokerStars Zoom Hand #258128829702:  Hold'em No Limit (€0.01/€0.02) [ADM ID: M62C63044C87BABT] - 2025/10/15 0:37:47 CET [2025/10/14 18:37:47 ET]
Table 'Sirio' 6-max Seat #1 is the button
Seat 1: 66lanci66 (€1.81 in chips) 
Seat 2: TheBullOfPoker (€2 in chips) 
Seat 3: caduceus369 (€2.90 in chips) 
Seat 4: gigiriver170 (€0.78 in chips) 
Seat 5: Vitto oolin (€0.73 in chips) 
Seat 6: Warterror90 (€4.32 in chips) 
TheBullOfPoker: posts small blind €0.01
caduceus369: posts big blind €0.02
*** HOLE CARDS ***
Dealt to caduceus369 [Qc 6c]
gigiriver170: calls €0.02
Vitto oolin: folds 
Warterror90: folds 
66lanci66: folds 
TheBullOfPoker: folds 
caduceus369: checks 
*** FLOP *** [6h 5c 7d]
caduceus369: checks 
gigiriver170: checks 
*** TURN *** [6h 5c 7d] [8s]
caduceus369: checks 
gigiriver170: checks 
*** RIVER *** [6h 5c 7d 8s] [7c]
caduceus369: checks 
gigiriver170: checks 
*** SHOW DOWN ***
caduceus369: shows [Qc 6c] (two pair, Sevens and Sixes)
gigiriver170: mucks hand 
caduceus369 collected €0.05 from pot
*** SUMMARY ***
Total pot €0.05 | Rake €0 
Board [6h 5c 7d 8s 7c]
Seat 1: 66lanci66 (button) folded before Flop (didn't bet)
Seat 2: TheBullOfPoker (small blind) folded before Flop
Seat 3: caduceus369 (big blind) showed [Qc 6c] and won (€0.05) with two pair, Sevens and Sixes
Seat 4: gigiriver170 mucked [5h Ks]
Seat 5: Vitto oolin folded before Flop (didn't bet)
Seat 6: Warterror90 folded before Flop (didn't bet)



PokerStars Zoom Hand #258128838033:  Hold'em No Limit (€0.01/€0.02) [ADM ID: M62C63044C87BABT] - 2025/10/15 0:38:28 CET [2025/10/14 18:38:28 ET]
Table 'Sirio' 6-max Seat #1 is the button
Seat 1: caduceus369 (€2.93 in chips) 
Seat 2: gigiriver170 (€0.76 in chips) 
Seat 3: ADRIAN0_MEIS (€3.76 in chips) 
Seat 4: mashallahh (€5.06 in chips) 
Seat 5: CarlaBBruni (€3.45 in chips) 
Seat 6: McSup (€3.95 in chips) 
gigiriver170: posts small blind €0.01
ADRIAN0_MEIS: posts big blind €0.02
*** HOLE CARDS ***
Dealt to caduceus369 [3s 5c]
mashallahh: folds 
CarlaBBruni: folds 
McSup: folds 
caduceus369: folds 
gigiriver170: calls €0.01
ADRIAN0_MEIS: checks 
*** FLOP *** [Qc Kh 3h]
gigiriver170: checks 
ADRIAN0_MEIS: checks 
*** TURN *** [Qc Kh 3h] [Tc]
gigiriver170: bets €0.02
ADRIAN0_MEIS: raises €0.06 to €0.08
gigiriver170: folds 
Uncalled bet (€0.06) returned to ADRIAN0_MEIS
ADRIAN0_MEIS collected €0.08 from pot
ADRIAN0_MEIS: doesn't show hand 
*** SUMMARY ***
Total pot €0.08 | Rake €0 
Board [Qc Kh 3h Tc]
Seat 1: caduceus369 (button) folded before Flop (didn't bet)
Seat 2: gigiriver170 (small blind) folded on the Turn
Seat 3: ADRIAN0_MEIS (big blind) collected (€0.08)
Seat 4: mashallahh folded before Flop (didn't bet)
Seat 5: CarlaBBruni folded before Flop (didn't bet)
Seat 6: McSup folded before Flop (didn't bet)



PokerStars Zoom Hand #258128840115:  Hold'em No Limit (€0.01/€0.02) [ADM ID: M62C63044C87BABT] - 2025/10/15 0:38:39 CET [2025/10/14 18:38:39 ET]
Table 'Sirio' 6-max Seat #1 is the button
Seat 1: Agnese84 (€2.25 in chips) 
Seat 2: caduceus369 (€2.93 in chips) 
Seat 3: McSup (€2.28 in chips) 
Seat 4: TheMule1454 (€3.27 in chips) 
Seat 5: Catania838 (€2.09 in chips) 
Seat 6: aurelios2 (€9.79 in chips) 
caduceus369: posts small blind €0.01
McSup: posts big blind €0.02
*** HOLE CARDS ***
Dealt to caduceus369 [Jd Kd]
TheMule1454: folds 
Catania838: folds 
aurelios2: folds 
Agnese84: calls €0.02
caduceus369: raises €0.06 to €0.08
McSup: calls €0.06
Agnese84: calls €0.06
*** FLOP *** [6c Qs Th]
caduceus369: checks 
McSup: checks 
Agnese84: checks 
*** TURN *** [6c Qs Th] [5s]
caduceus369: bets €0.06
McSup: calls €0.06
Agnese84: folds 
*** RIVER *** [6c Qs Th 5s] [3s]
caduceus369: checks 
McSup: bets €0.18
caduceus369: folds 
Uncalled bet (€0.18) returned to McSup
McSup collected €0.35 from pot
McSup: doesn't show hand 
*** SUMMARY ***
Total pot €0.36 | Rake €0.01 
Board [6c Qs Th 5s 3s]
Seat 1: Agnese84 (button) folded on the Turn
Seat 2: caduceus369 (small blind) folded on the River
Seat 3: McSup (big blind) collected (€0.35)
Seat 4: TheMule1454 folded before Flop (didn't bet)
Seat 5: Catania838 folded before Flop (didn't bet)
Seat 6: aurelios2 folded before Flop (didn't bet)



PokerStars Zoom Hand #258128858619:  Hold'em No Limit (€0.01/€0.02) [ADM ID: M62C63044C87BABT] - 2025/10/15 0:40:11 CET [2025/10/14 18:40:11 ET]
Table 'Sirio' 6-max Seat #1 is the button
Seat 1: father2008 (€2.11 in chips) 
Seat 2: mashallahh (€7.28 in chips) 
Seat 3: caduceus369 (€2.79 in chips) 
Seat 4: 66lanci66 (€1.69 in chips) 
Seat 5: TheMule1454 (€1.93 in chips) 
Seat 6: Begimon (€12.53 in chips) 
mashallahh: posts small blind €0.01
caduceus369: posts big blind €0.02
*** HOLE CARDS ***
Dealt to caduceus369 [5d 4h]
66lanci66: folds 
TheMule1454: folds 
Begimon: folds 
father2008: folds 
mashallahh: folds 
Uncalled bet (€0.01) returned to caduceus369
caduceus369 collected €0.02 from pot
caduceus369: doesn't show hand 
*** SUMMARY ***
Total pot €0.02 | Rake €0 
Seat 1: father2008 (button) folded before Flop (didn't bet)
Seat 2: mashallahh (small blind) folded before Flop
Seat 3: caduceus369 (big blind) collected (€0.02)
Seat 4: 66lanci66 folded before Flop (didn't bet)
Seat 5: TheMule1454 folded before Flop (didn't bet)
Seat 6: Begimon folded before Flop (didn't bet)



PokerStars Zoom Hand #258128862798:  Hold'em No Limit (€0.01/€0.02) [ADM ID: M62C63044C87BABT] - 2025/10/15 0:40:33 CET [2025/10/14 18:40:33 ET]
Table 'Sirio' 6-max Seat #1 is the button
Seat 1: TheMule1454 (€1.93 in chips) 
Seat 2: cryyh (€3.95 in chips) 
Seat 3: McSup (€4.05 in chips) 
Seat 4: mashallahh (€7.27 in chips) 
Seat 5: caduceus369 (€2.80 in chips) 
Seat 6: SebaRapy14 (€3.05 in chips) 
cryyh: posts small blind €0.01
McSup: posts big blind €0.02
*** HOLE CARDS ***
Dealt to caduceus369 [9c 4c]
mashallahh: folds 
caduceus369: folds 
SebaRapy14: folds 
TheMule1454: folds 
cryyh: raises €0.04 to €0.06
McSup: raises €0.12 to €0.18
cryyh: folds 
Uncalled bet (€0.12) returned to McSup
McSup collected €0.12 from pot
McSup: doesn't show hand 
*** SUMMARY ***
Total pot €0.12 | Rake €0 
Seat 1: TheMule1454 (button) folded before Flop (didn't bet)
Seat 2: cryyh (small blind) folded before Flop
Seat 3: McSup (big blind) collected (€0.12)
Seat 4: mashallahh folded before Flop (didn't bet)
Seat 5: caduceus369 folded before Flop (didn't bet)
Seat 6: SebaRapy14 folded before Flop (didn't bet)



PokerStars Zoom Hand #258128856047:  Hold'em No Limit (€0.01/€0.02) [ADM ID: M62C63044C87BABT] - 2025/10/15 0:39:59 CET [2025/10/14 18:39:59 ET]
Table 'Sirio' 6-max Seat #1 is the button
Seat 1: CarlaBBruni (€1.75 in chips) 
Seat 2: Crock361 (€2 in chips) 
Seat 3: mashallahh (€8.08 in chips) 
Seat 4: meteco79 (€0.98 in chips) 
Seat 5: McSup (€2.49 in chips) 
Seat 6: caduceus369 (€2.79 in chips) 
Crock361: posts small blind €0.01
mashallahh: posts big blind €0.02
*** HOLE CARDS ***
Dealt to caduceus369 [4s Tc]
meteco79: calls €0.02
McSup: calls €0.02
caduceus369: folds 
CarlaBBruni: calls €0.02
Crock361: folds 
mashallahh: checks 
*** FLOP *** [Jh 8h 8c]
mashallahh: checks 
meteco79: checks 
McSup: bets €0.05
CarlaBBruni: calls €0.05
mashallahh: folds 
meteco79: folds 
*** TURN *** [Jh 8h 8c] [Ks]
McSup: checks 
CarlaBBruni: bets €0.10
McSup: calls €0.10
*** RIVER *** [Jh 8h 8c Ks] [7d]
McSup: checks 
CarlaBBruni: checks 
*** SHOW DOWN ***
McSup: shows [Ah 7h] (two pair, Eights and Sevens)
CarlaBBruni: mucks hand 
McSup collected €0.37 from pot
*** SUMMARY ***
Total pot €0.39 | Rake €0.02 
Board [Jh 8h 8c Ks 7d]
Seat 1: CarlaBBruni (button) mucked [Ts Qh]
Seat 2: Crock361 (small blind) folded before Flop
Seat 3: mashallahh (big blind) folded on the Flop
Seat 4: meteco79 folded on the Flop
Seat 5: McSup showed [Ah 7h] and won (€0.37) with two pair, Eights and Sevens
Seat 6: caduceus369 folded before Flop (didn't bet)



PokerStars Zoom Hand #258128857688:  Hold'em No Limit (€0.01/€0.02) [ADM ID: M62C63044C87BABT] - 2025/10/15 0:40:07 CET [2025/10/14 18:40:07 ET]
Table 'Sirio' 6-max Seat #1 is the button
Seat 1: TheMule1454 (€3.55 in chips) 
Seat 2: Catania838 (€2.54 in chips) 
Seat 3: mashallahh (€2.62 in chips) 
Seat 4: 2PaperelaSgubio (€2.86 in chips) 
Seat 5: caduceus369 (€2.79 in chips) 
Seat 6: Rrrr322 (€1.79 in chips) 
Catania838: posts small blind €0.01
mashallahh: posts big blind €0.02
*** HOLE CARDS ***
Dealt to caduceus369 [4h Ts]
2PaperelaSgubio: folds 
caduceus369: folds 
Rrrr322: calls €0.02
TheMule1454: folds 
Catania838: calls €0.01
mashallahh: raises €0.06 to €0.08
Rrrr322: calls €0.06
Catania838: calls €0.06
*** FLOP *** [Kh 2c Ad]
Catania838: checks 
mashallahh: checks 
Rrrr322: checks 
*** TURN *** [Kh 2c Ad] [2d]
Catania838: checks 
mashallahh: checks 
Rrrr322: checks 
*** RIVER *** [Kh 2c Ad 2d] [Td]
Catania838: bets €0.23
mashallahh: folds 
Rrrr322: raises €0.69 to €0.92
Catania838: calls €0.69
*** SHOW DOWN ***
Rrrr322: shows [2h Js] (three of a kind, Deuces)
Catania838: shows [Jh Qh] (a straight, Ten to Ace)
Catania838 collected €1.97 from pot
*** SUMMARY ***
Total pot €2.08 | Rake €0.11 
Board [Kh 2c Ad 2d Td]
Seat 1: TheMule1454 (button) folded before Flop (didn't bet)
Seat 2: Catania838 (small blind) showed [Jh Qh] and won (€1.97) with a straight, Ten to Ace
Seat 3: mashallahh (big blind) folded on the River
Seat 4: 2PaperelaSgubio folded before Flop (didn't bet)
Seat 5: caduceus369 folded before Flop (didn't bet)
Seat 6: Rrrr322 showed [2h Js] and lost with three of a kind, Deuces



PokerStars Zoom Hand #258128861065:  Hold'em No Limit (€0.01/€0.02) [ADM ID: M62C63044C87BABT] - 2025/10/15 0:40:24 CET [2025/10/14 18:40:24 ET]
Table 'Sirio' 6-max Seat #1 is the button
Seat 1: Agnese84 (€2.16 in chips) 
Seat 2: McSup (€4.06 in chips) 
Seat 3: father2008 (€2.23 in chips) 
Seat 4: caduceus369 (€2.80 in chips) 
Seat 5: aurelios2 (€9.72 in chips) 
Seat 6: Alifatti (€0.69 in chips) 
McSup: posts small blind €0.01
father2008: posts big blind €0.02
*** HOLE CARDS ***
Dealt to caduceus369 [3c 9c]
caduceus369: folds 
aurelios2: folds 
Alifatti: folds 
Agnese84: calls €0.02
McSup: folds 
father2008: checks 
*** FLOP *** [8s 8d Td]
father2008: checks 
Agnese84: bets €0.05
father2008: folds 
Uncalled bet (€0.05) returned to Agnese84
Agnese84 collected €0.05 from pot
Agnese84: doesn't show hand 
*** SUMMARY ***
Total pot €0.05 | Rake €0 
Board [8s 8d Td]
Seat 1: Agnese84 (button) collected (€0.05)
Seat 2: McSup (small blind) folded before Flop
Seat 3: father2008 (big blind) folded on the Flop
Seat 4: caduceus369 folded before Flop (didn't bet)
Seat 5: aurelios2 folded before Flop (didn't bet)
Seat 6: Alifatti folded before Flop (didn't bet)



PokerStars Zoom Hand #258128864272:  Hold'em No Limit (€0.01/€0.02) [ADM ID: M62C63044C87BABT] - 2025/10/15 0:40:40 CET [2025/10/14 18:40:40 ET]
Table 'Sirio' 6-max Seat #1 is the button
Seat 1: SebaRapy14 (€3.05 in chips) 
Seat 2: caduceus369 (€2.80 in chips) 
Seat 3: mashallahh (€7.27 in chips) 
Seat 4: talpa890 (€2.20 in chips) 
Seat 5: Alifatti (€0.69 in chips) 
Seat 6: maury999999 (€4.06 in chips) 
caduceus369: posts small blind €0.01
mashallahh: posts big blind €0.02
*** HOLE CARDS ***
Dealt to caduceus369 [Kc Jc]
talpa890: calls €0.02
Alifatti: calls €0.02
maury999999: folds 
SebaRapy14: folds 
caduceus369: raises €0.04 to €0.06
mashallahh: folds 
talpa890: calls €0.04
Alifatti: calls €0.04
*** FLOP *** [5s 9d 4d]
caduceus369: checks 
talpa890: checks 
Alifatti: checks 
*** TURN *** [5s 9d 4d] [2s]
caduceus369: checks 
talpa890: checks 
Alifatti: bets €0.10
caduceus369: folds 
talpa890: folds 
Uncalled bet (€0.10) returned to Alifatti
Alifatti collected €0.19 from pot
Alifatti: doesn't show hand 
*** SUMMARY ***
Total pot €0.20 | Rake €0.01 
Board [5s 9d 4d 2s]
Seat 1: SebaRapy14 (button) folded before Flop (didn't bet)
Seat 2: caduceus369 (small blind) folded on the Turn
Seat 3: mashallahh (big blind) folded before Flop
Seat 4: talpa890 folded on the Turn
Seat 5: Alifatti collected (€0.19)
Seat 6: maury999999 folded before Flop (didn't bet)



PokerStars Zoom Hand #258128875844:  Hold'em No Limit (€0.01/€0.02) [ADM ID: M62C63044C87BABT] - 2025/10/15 0:41:39 CET [2025/10/14 18:41:39 ET]
Table 'Sirio' 6-max Seat #1 is the button
Seat 1: Crock361 (€2.04 in chips) 
Seat 2: SebaRapy14 (€0.44 in chips) 
Seat 3: Warterror90 (€4.12 in chips) 
Seat 4: caduceus369 (€2.74 in chips) 
Seat 5: CIKO71131 (€0.67 in chips) 
Seat 6: TheMule1454 (€3.64 in chips) 
SebaRapy14: posts small blind €0.01
Warterror90: posts big blind €0.02
*** HOLE CARDS ***
Dealt to caduceus369 [2c Ac]
caduceus369: folds 
CIKO71131: folds 
TheMule1454: folds 
Crock361: folds 
SebaRapy14: folds 
Uncalled bet (€0.01) returned to Warterror90
Warterror90 collected €0.02 from pot
Warterror90: doesn't show hand 
*** SUMMARY ***
Total pot €0.02 | Rake €0 
Seat 1: Crock361 (button) folded before Flop (didn't bet)
Seat 2: SebaRapy14 (small blind) folded before Flop
Seat 3: Warterror90 (big blind) collected (€0.02)
Seat 4: caduceus369 folded before Flop (didn't bet)
Seat 5: CIKO71131 folded before Flop (didn't bet)
Seat 6: TheMule1454 folded before Flop (didn't bet)



PokerStars Zoom Hand #258128873907:  Hold'em No Limit (€0.01/€0.02) [ADM ID: M62C63044C87BABT] - 2025/10/15 0:41:29 CET [2025/10/14 18:41:29 ET]
Table 'Sirio' 6-max Seat #1 is the button
Seat 1: father2008 (€2.20 in chips) 
Seat 2: 2PaperelaSgubio (€2.68 in chips) 
Seat 3: Alifatti (€0.82 in chips) 
Seat 4: McSup (€2.68 in chips) 
Seat 5: mashallahh (€2.53 in chips) 
Seat 6: caduceus369 (€2.74 in chips) 
2PaperelaSgubio: posts small blind €0.01
Alifatti: posts big blind €0.02
*** HOLE CARDS ***
Dealt to caduceus369 [2s Kc]
McSup: folds 
mashallahh: folds 
caduceus369: folds 
father2008: raises €0.04 to €0.06
2PaperelaSgubio: raises €0.18 to €0.24
Alifatti: folds 
father2008: folds 
Uncalled bet (€0.18) returned to 2PaperelaSgubio
2PaperelaSgubio collected €0.14 from pot
2PaperelaSgubio: doesn't show hand 
*** SUMMARY ***
Total pot €0.14 | Rake €0 
Seat 1: father2008 (button) folded before Flop
Seat 2: 2PaperelaSgubio (small blind) collected (€0.14)
Seat 3: Alifatti (big blind) folded before Flop
Seat 4: McSup folded before Flop (didn't bet)
Seat 5: mashallahh folded before Flop (didn't bet)
Seat 6: caduceus369 folded before Flop (didn't bet)



PokerStars Zoom Hand #258128873190:  Hold'em No Limit (€0.01/€0.02) [ADM ID: M62C63044C87BABT] - 2025/10/15 0:41:25 CET [2025/10/14 18:41:25 ET]
Table 'Sirio' 6-max Seat #1 is the button
Seat 1: caduceus369 (€2.74 in chips) 
Seat 2: TheMule1454 (€1.81 in chips) 
Seat 3: Catania838 (€3.51 in chips) 
Seat 4: Warterror90 (€3.46 in chips) 
Seat 5: Crock361 (€2.04 in chips) 
Seat 6: talpa890 (€2.14 in chips) 
TheMule1454: posts small blind €0.01
Catania838: posts big blind €0.02
*** HOLE CARDS ***
Dealt to caduceus369 [6c Jh]
Warterror90: raises €0.04 to €0.06
Crock361: folds 
talpa890: folds 
caduceus369: folds 
TheMule1454: calls €0.05
Catania838: folds 
*** FLOP *** [Kd Qh Qc]
TheMule1454: checks 
Warterror90: checks 
*** TURN *** [Kd Qh Qc] [Ks]
TheMule1454: checks 
Warterror90: bets €0.05
TheMule1454: calls €0.05
*** RIVER *** [Kd Qh Qc Ks] [2d]
TheMule1454: checks 
Warterror90: checks 
*** SHOW DOWN ***
TheMule1454: shows [Td Jd] (two pair, Kings and Queens)
Warterror90: shows [Ac Tc] (two pair, Kings and Queens - Ace kicker)
Warterror90 collected €0.23 from pot
*** SUMMARY ***
Total pot €0.24 | Rake €0.01 
Board [Kd Qh Qc Ks 2d]
Seat 1: caduceus369 (button) folded before Flop (didn't bet)
Seat 2: TheMule1454 (small blind) showed [Td Jd] and lost with two pair, Kings and Queens
Seat 3: Catania838 (big blind) folded before Flop
Seat 4: Warterror90 showed [Ac Tc] and won (€0.23) with two pair, Kings and Queens
Seat 5: Crock361 folded before Flop (didn't bet)
Seat 6: talpa890 folded before Flop (didn't bet)



PokerStars Zoom Hand #258128881605:  Hold'em No Limit (€0.01/€0.02) [ADM ID: M62C63044C87BABT] - 2025/10/15 0:42:08 CET [2025/10/14 18:42:08 ET]
Table 'Sirio' 6-max Seat #1 is the button
Seat 1: mashallahh (€5.36 in chips) 
Seat 2: This Heat (€1.72 in chips) 
Seat 3: SebaRapy14 (€0.43 in chips) 
Seat 4: 2PaperelaSgubio (€2.85 in chips) 
Seat 5: caduceus369 (€2.72 in chips) 
Seat 6: McSup (€2.65 in chips) 
This Heat: posts small blind €0.01
SebaRapy14: posts big blind €0.02
*** HOLE CARDS ***
Dealt to caduceus369 [Td 7h]
2PaperelaSgubio: folds 
caduceus369: folds 
McSup: folds 
mashallahh: folds 
This Heat: folds 
Uncalled bet (€0.01) returned to SebaRapy14
SebaRapy14 collected €0.02 from pot
SebaRapy14: doesn't show hand 
*** SUMMARY ***
Total pot €0.02 | Rake €0 
Seat 1: mashallahh (button) folded before Flop (didn't bet)
Seat 2: This Heat (small blind) folded before Flop
Seat 3: SebaRapy14 (big blind) collected (€0.02)
Seat 4: 2PaperelaSgubio folded before Flop (didn't bet)
Seat 5: caduceus369 folded before Flop (didn't bet)
Seat 6: McSup folded before Flop (didn't bet)



PokerStars Zoom Hand #258128883177:  Hold'em No Limit (€0.01/€0.02) [ADM ID: M62C63044C87BABT] - 2025/10/15 0:42:16 CET [2025/10/14 18:42:16 ET]
Table 'Sirio' 6-max Seat #1 is the button
Seat 1: This Heat (€1.71 in chips) 
Seat 2: caduceus369 (€2.72 in chips) 
Seat 3: Warterror90 (€3.58 in chips) 
Seat 4: Crock361 (€1.99 in chips) 
Seat 5: McSup (€4.05 in chips) 
Seat 6: Catania838 (€3.48 in chips) 
caduceus369: posts small blind €0.01
Warterror90: posts big blind €0.02
*** HOLE CARDS ***
Dealt to caduceus369 [Ts 6s]
Crock361: folds 
McSup: folds 
Catania838: folds 
This Heat: raises €0.04 to €0.06
caduceus369: folds 
Warterror90: folds 
Uncalled bet (€0.04) returned to This Heat
This Heat collected €0.05 from pot
This Heat: doesn't show hand 
*** SUMMARY ***
Total pot €0.05 | Rake €0 
Seat 1: This Heat (button) collected (€0.05)
Seat 2: caduceus369 (small blind) folded before Flop
Seat 3: Warterror90 (big blind) folded before Flop
Seat 4: Crock361 folded before Flop (didn't bet)
Seat 5: McSup folded before Flop (didn't bet)
Seat 6: Catania838 folded before Flop (didn't bet)



PokerStars Zoom Hand #258128876868:  Hold'em No Limit (€0.01/€0.02) [ADM ID: M62C63044C87BABT] - 2025/10/15 0:41:44 CET [2025/10/14 18:41:44 ET]
Table 'Sirio' 6-max Seat #1 is the button
Seat 1: SebaRapy14 (€0.43 in chips) 
Seat 2: Catania838 (€3.49 in chips) 
Seat 3: caduceus369 (€2.74 in chips) 
Seat 4: Crock361 (€2.04 in chips) 
Seat 5: Freddy15081988 (€1.70 in chips) 
Seat 6: gigiriver170 (€0.34 in chips) 
Catania838: posts small blind €0.01
caduceus369: posts big blind €0.02
*** HOLE CARDS ***
Dealt to caduceus369 [8c Ah]
Crock361: folds 
Freddy15081988: calls €0.02
gigiriver170: calls €0.02
SebaRapy14: folds 
Catania838: folds 
caduceus369: checks 
*** FLOP *** [3c 7h Kh]
caduceus369: checks 
Freddy15081988: checks 
gigiriver170: bets €0.07
caduceus369: folds 
Freddy15081988: calls €0.07
*** TURN *** [3c 7h Kh] [5d]
Freddy15081988: checks 
gigiriver170: bets €0.10
Freddy15081988: calls €0.10
*** RIVER *** [3c 7h Kh 5d] [2h]
Freddy15081988: bets €0.20
gigiriver170: calls €0.15 and is all-in
Uncalled bet (€0.05) returned to Freddy15081988
*** SHOW DOWN ***
Freddy15081988: shows [Kd 4h] (a pair of Kings)
gigiriver170: shows [Kc Jd] (a pair of Kings - Jack kicker)
gigiriver170 collected €0.68 from pot
*** SUMMARY ***
Total pot €0.71 | Rake €0.03 
Board [3c 7h Kh 5d 2h]
Seat 1: SebaRapy14 (button) folded before Flop (didn't bet)
Seat 2: Catania838 (small blind) folded before Flop
Seat 3: caduceus369 (big blind) folded on the Flop
Seat 4: Crock361 folded before Flop (didn't bet)
Seat 5: Freddy15081988 showed [Kd 4h] and lost with a pair of Kings
Seat 6: gigiriver170 showed [Kc Jd] and won (€0.68) with a pair of Kings



PokerStars Zoom Hand #258128886615:  Hold'em No Limit (€0.01/€0.02) [ADM ID: M62C63044C87BABT] - 2025/10/15 0:42:34 CET [2025/10/14 18:42:34 ET]
Table 'Sirio' 6-max Seat #1 is the button
Seat 1: ilteatro131 (€2.04 in chips) 
Seat 2: father2008 (€2.15 in chips) 
Seat 3: Catania838 (€3.47 in chips) 
Seat 4: 2PaperelaSgubio (€2.86 in chips) 
Seat 5: This Heat (€1.74 in chips) 
Seat 6: caduceus369 (€2.71 in chips) 
father2008: posts small blind €0.01
Catania838: posts big blind €0.02
*** HOLE CARDS ***
Dealt to caduceus369 [4d 6h]
2PaperelaSgubio: folds 
This Heat: raises €0.04 to €0.06
caduceus369: folds 
ilteatro131: folds 
father2008: folds 
Catania838: folds 
Uncalled bet (€0.04) returned to This Heat
This Heat collected €0.05 from pot
This Heat: doesn't show hand 
*** SUMMARY ***
Total pot €0.05 | Rake €0 
Seat 1: ilteatro131 (button) folded before Flop (didn't bet)
Seat 2: father2008 (small blind) folded before Flop
Seat 3: Catania838 (big blind) folded before Flop
Seat 4: 2PaperelaSgubio folded before Flop (didn't bet)
Seat 5: This Heat collected (€0.05)
Seat 6: caduceus369 folded before Flop (didn't bet)



PokerStars Zoom Hand #258128885449:  Hold'em No Limit (€0.01/€0.02) [ADM ID: M62C63044C87BABT] - 2025/10/15 0:42:28 CET [2025/10/14 18:42:28 ET]
Table 'Sirio' 6-max Seat #1 is the button
Seat 1: meteco79 (€0.98 in chips) 
Seat 2: SebaRapy14 (€0.44 in chips) 
Seat 3: Warterror90 (€4.12 in chips) 
Seat 4: father2008 (€2.12 in chips) 
Seat 5: caduceus369 (€2.71 in chips) 
Seat 6: Alifatti (€0.77 in chips) 
SebaRapy14: posts small blind €0.01
Warterror90: posts big blind €0.02
*** HOLE CARDS ***
Dealt to caduceus369 [4h 9h]
father2008: folds 
caduceus369: folds 
Alifatti: calls €0.02
meteco79: calls €0.02
SebaRapy14: calls €0.01
Warterror90: raises €0.04 to €0.06
Alifatti: calls €0.04
meteco79: calls €0.04
SebaRapy14: folds 
*** FLOP *** [Tc 8c 2d]
Warterror90: checks 
Alifatti: checks 
meteco79: bets €0.02
Warterror90: calls €0.02
Alifatti: calls €0.02
*** TURN *** [Tc 8c 2d] [8h]
Warterror90: checks 
Alifatti: checks 
meteco79: bets €0.25
Warterror90: folds 
Alifatti: folds 
Uncalled bet (€0.25) returned to meteco79
meteco79 collected €0.25 from pot
meteco79: doesn't show hand 
*** SUMMARY ***
Total pot €0.26 | Rake €0.01 
Board [Tc 8c 2d 8h]
Seat 1: meteco79 (button) collected (€0.25)
Seat 2: SebaRapy14 (small blind) folded before Flop
Seat 3: Warterror90 (big blind) folded on the Turn
Seat 4: father2008 folded before Flop (didn't bet)
Seat 5: caduceus369 folded before Flop (didn't bet)
Seat 6: Alifatti folded on the Turn



PokerStars Zoom Hand #258128889530:  Hold'em No Limit (€0.01/€0.02) [ADM ID: M62C63044C87BABT] - 2025/10/15 0:42:49 CET [2025/10/14 18:42:49 ET]
Table 'Sirio' 6-max Seat #1 is the button
Seat 1: mashallahh (€2.63 in chips) 
Seat 2: bv0360 (€0.95 in chips) 
Seat 3: caduceus369 (€2.71 in chips) 
Seat 4: Catania838 (€2.39 in chips) 
Seat 5: Agnese84 (€2.38 in chips) 
Seat 6: father2008 (€2.12 in chips) 
bv0360: posts small blind €0.01
caduceus369: posts big blind €0.02
*** HOLE CARDS ***
Dealt to caduceus369 [Tc Ts]
Catania838: folds 
Agnese84: folds 
father2008: folds 
mashallahh: raises €0.04 to €0.06
bv0360: calls €0.05
caduceus369: raises €0.16 to €0.22
mashallahh: folds 
bv0360: calls €0.16
*** FLOP *** [Ad Kd Ac]
bv0360: checks 
caduceus369: bets €0.16
bv0360: calls €0.16
*** TURN *** [Ad Kd Ac] [4h]
bv0360: checks 
caduceus369: checks 
*** RIVER *** [Ad Kd Ac 4h] [Jc]
bv0360: bets €0.57 and is all-in
caduceus369: folds 
Uncalled bet (€0.57) returned to bv0360
bv0360 collected €0.78 from pot
bv0360: doesn't show hand 
*** SUMMARY ***
Total pot €0.82 | Rake €0.04 
Board [Ad Kd Ac 4h Jc]
Seat 1: mashallahh (button) folded before Flop
Seat 2: bv0360 (small blind) collected (€0.78)
Seat 3: caduceus369 (big blind) folded on the River
Seat 4: Catania838 folded before Flop (didn't bet)
Seat 5: Agnese84 folded before Flop (didn't bet)
Seat 6: father2008 folded before Flop (didn't bet)



PokerStars Zoom Hand #258128901652:  Hold'em No Limit (€0.01/€0.02) [ADM ID: M62C63044C87BABT] - 2025/10/15 0:43:53 CET [2025/10/14 18:43:53 ET]
Table 'Sirio' 6-max Seat #1 is the button
Seat 1: caduceus369 (€2.33 in chips) 
Seat 2: aurelios2 (€9.31 in chips) 
Seat 3: 2PaperelaSgubio (€2.71 in chips) 
Seat 4: Catania838 (€3.38 in chips) 
Seat 5: ilteatro131 (€1.95 in chips) 
Seat 6: TheMule1454 (€1.44 in chips) 
aurelios2: posts small blind €0.01
2PaperelaSgubio: posts big blind €0.02
*** HOLE CARDS ***
Dealt to caduceus369 [Ks 5h]
Catania838: folds 
ilteatro131: calls €0.02
TheMule1454 has timed out
TheMule1454: folds 
caduceus369: folds 
aurelios2: folds 
2PaperelaSgubio: checks 
*** FLOP *** [Ac 9s 3c]
2PaperelaSgubio: checks 
ilteatro131: checks 
*** TURN *** [Ac 9s 3c] [4h]
2PaperelaSgubio: checks 
ilteatro131: checks 
*** RIVER *** [Ac 9s 3c 4h] [5s]
2PaperelaSgubio: checks 
ilteatro131: checks 
*** SHOW DOWN ***
2PaperelaSgubio: shows [Jh 4c] (a pair of Fours)
ilteatro131: mucks hand 
2PaperelaSgubio collected €0.05 from pot
*** SUMMARY ***
Total pot €0.05 | Rake €0 
Board [Ac 9s 3c 4h 5s]
Seat 1: caduceus369 (button) folded before Flop (didn't bet)
Seat 2: aurelios2 (small blind) folded before Flop
Seat 3: 2PaperelaSgubio (big blind) showed [Jh 4c] and won (€0.05) with a pair of Fours
Seat 4: Catania838 folded before Flop (didn't bet)
Seat 5: ilteatro131 mucked [Qs Ts]
Seat 6: TheMule1454 folded before Flop (didn't bet)



PokerStars Zoom Hand #258128904069:  Hold'em No Limit (€0.01/€0.02) [ADM ID: M62C63044C87BABT] - 2025/10/15 0:44:06 CET [2025/10/14 18:44:06 ET]
Table 'Sirio' 6-max Seat #1 is the button
Seat 1: Catania838 (€2.59 in chips) 
Seat 2: McSup (€3.99 in chips) 
Seat 3: maury999999 (€4.71 in chips) 
Seat 4: caduceus369 (€2.33 in chips) 
Seat 5: Crock361 (€1.71 in chips) 
Seat 6: mashallahh (€8.06 in chips) 
McSup: posts small blind €0.01
maury999999: posts big blind €0.02
*** HOLE CARDS ***
Dealt to caduceus369 [5h Qs]
caduceus369: folds 
Crock361: folds 
maury999999 is disconnected 
mashallahh: folds 
Catania838: folds 
McSup: folds 
Uncalled bet (€0.01) returned to maury999999
maury999999 collected €0.02 from pot
maury999999: doesn't show hand 
*** SUMMARY ***
Total pot €0.02 | Rake €0 
Seat 1: Catania838 (button) folded before Flop (didn't bet)
Seat 2: McSup (small blind) folded before Flop
Seat 3: maury999999 (big blind) collected (€0.02)
Seat 4: caduceus369 folded before Flop (didn't bet)
Seat 5: Crock361 folded before Flop (didn't bet)
Seat 6: mashallahh folded before Flop (didn't bet)



PokerStars Zoom Hand #258128905409:  Hold'em No Limit (€0.01/€0.02) [ADM ID: M62C63044C87BABT] - 2025/10/15 0:44:13 CET [2025/10/14 18:44:13 ET]
Table 'Sirio' 6-max Seat #1 is the button
Seat 1: 2PaperelaSgubio (€2.67 in chips) 
Seat 2: caduceus369 (€2.33 in chips) 
Seat 3: Crock361 (€2.09 in chips) 
Seat 4: Warterror90 (€4.19 in chips) 
Seat 5: TheMule1454 (€1.39 in chips) 
Seat 6: CarlaBBruni (€1.88 in chips) 
caduceus369: posts small blind €0.01
Crock361: posts big blind €0.02
*** HOLE CARDS ***
Dealt to caduceus369 [Ad Tc]
Warterror90: folds 
TheMule1454: raises €0.06 to €0.08
CarlaBBruni: calls €0.08
2PaperelaSgubio: folds 
caduceus369: folds 
Crock361: folds 
*** FLOP *** [Kd 7c 4h]
TheMule1454: checks 
CarlaBBruni: bets €0.06
TheMule1454: folds 
Uncalled bet (€0.06) returned to CarlaBBruni
CarlaBBruni collected €0.18 from pot
CarlaBBruni: doesn't show hand 
*** SUMMARY ***
Total pot €0.19 | Rake €0.01 
Board [Kd 7c 4h]
Seat 1: 2PaperelaSgubio (button) folded before Flop (didn't bet)
Seat 2: caduceus369 (small blind) folded before Flop
Seat 3: Crock361 (big blind) folded before Flop
Seat 4: Warterror90 folded before Flop (didn't bet)
Seat 5: TheMule1454 folded on the Flop
Seat 6: CarlaBBruni collected (€0.18)



PokerStars Zoom Hand #258128911148:  Hold'em No Limit (€0.01/€0.02) [ADM ID: M62C63044C87BABT] - 2025/10/15 0:44:43 CET [2025/10/14 18:44:43 ET]
Table 'Sirio' 6-max Seat #1 is the button
Seat 1: caduceus369 (€2.32 in chips) 
Seat 2: Crock361 (€1.99 in chips) 
Seat 3: Temait77728 (€0.83 in chips) 
Seat 4: mashallahh (€8.06 in chips) 
Seat 5: CarlaBBruni (€3.95 in chips) 
Seat 6: TheMule1454 (€2.76 in chips) 
Crock361: posts small blind €0.01
Temait77728: posts big blind €0.02
*** HOLE CARDS ***
Dealt to caduceus369 [6s Jc]
mashallahh: raises €0.04 to €0.06
CarlaBBruni: folds 
TheMule1454: folds 
caduceus369: folds 
Crock361: folds 
Temait77728: folds 
Uncalled bet (€0.04) returned to mashallahh
mashallahh collected €0.05 from pot
mashallahh: doesn't show hand 
*** SUMMARY ***
Total pot €0.05 | Rake €0 
Seat 1: caduceus369 (button) folded before Flop (didn't bet)
Seat 2: Crock361 (small blind) folded before Flop
Seat 3: Temait77728 (big blind) folded before Flop
Seat 4: mashallahh collected (€0.05)
Seat 5: CarlaBBruni folded before Flop (didn't bet)
Seat 6: TheMule1454 folded before Flop (didn't bet)



PokerStars Zoom Hand #258128912671:  Hold'em No Limit (€0.01/€0.02) [ADM ID: M62C63044C87BABT] - 2025/10/15 0:44:51 CET [2025/10/14 18:44:51 ET]
Table 'Sirio' 6-max Seat #1 is the button
Seat 1: Warterror90 (€4.12 in chips) 
Seat 2: Temait77728 (€0.81 in chips) 
Seat 3: McSup (€3.98 in chips) 
Seat 4: CarlaBBruni (€1.98 in chips) 
Seat 5: 2PaperelaSgubio (€2.70 in chips) 
Seat 6: caduceus369 (€2.32 in chips) 
Temait77728: posts small blind €0.01
McSup: posts big blind €0.02
*** HOLE CARDS ***
Dealt to caduceus369 [8s 7d]
CarlaBBruni: folds 
2PaperelaSgubio: folds 
caduceus369: folds 
Warterror90: folds 
Temait77728: folds 
Uncalled bet (€0.01) returned to McSup
McSup collected €0.02 from pot
McSup: doesn't show hand 
*** SUMMARY ***
Total pot €0.02 | Rake €0 
Seat 1: Warterror90 (button) folded before Flop (didn't bet)
Seat 2: Temait77728 (small blind) folded before Flop
Seat 3: McSup (big blind) collected (€0.02)
Seat 4: CarlaBBruni folded before Flop (didn't bet)
Seat 5: 2PaperelaSgubio folded before Flop (didn't bet)
Seat 6: caduceus369 folded before Flop (didn't bet)



PokerStars Zoom Hand #258128909583:  Hold'em No Limit (€0.01/€0.02) [ADM ID: M62C63044C87BABT] - 2025/10/15 0:44:35 CET [2025/10/14 18:44:35 ET]
Table 'Sirio' 6-max Seat #1 is the button
Seat 1: Begimon (€12.36 in chips) 
Seat 2: Crock361 (€2.03 in chips) 
Seat 3: Warterror90 (€4.08 in chips) 
Seat 4: caduceus369 (€2.32 in chips) 
Seat 5: TheMule1454 (€1.43 in chips) 
Seat 6: McSup (€3.98 in chips) 
Crock361: posts small blind €0.01
Warterror90: posts big blind €0.02
*** HOLE CARDS ***
Dealt to caduceus369 [Jd 3c]
caduceus369: folds 
TheMule1454: folds 
McSup: folds 
Begimon: calls €0.02
Crock361: folds 
Warterror90: checks 
*** FLOP *** [8c 5h 2s]
Warterror90: checks 
Begimon: bets €0.02
Warterror90: raises €0.02 to €0.04
Begimon: calls €0.02
*** TURN *** [8c 5h 2s] [Qc]
Warterror90: bets €0.04
Begimon: calls €0.04
*** RIVER *** [8c 5h 2s Qc] [Qd]
Warterror90: checks 
Begimon: bets €0.04
Warterror90: calls €0.04
*** SHOW DOWN ***
Begimon: shows [8h 7h] (two pair, Queens and Eights)
Warterror90: mucks hand 
Begimon collected €0.28 from pot
*** SUMMARY ***
Total pot €0.29 | Rake €0.01 
Board [8c 5h 2s Qc Qd]
Seat 1: Begimon (button) showed [8h 7h] and won (€0.28) with two pair, Queens and Eights
Seat 2: Crock361 (small blind) folded before Flop
Seat 3: Warterror90 (big blind) mucked [5d 4c]
Seat 4: caduceus369 folded before Flop (didn't bet)
Seat 5: TheMule1454 folded before Flop (didn't bet)
Seat 6: McSup folded before Flop (didn't bet)



PokerStars Zoom Hand #258128913829:  Hold'em No Limit (€0.01/€0.02) [ADM ID: M62C63044C87BABT] - 2025/10/15 0:44:57 CET [2025/10/14 18:44:57 ET]
Table 'Sirio' 6-max Seat #1 is the button
Seat 1: Crock361 (€1.98 in chips) 
Seat 2: TheMule1454 (€1.31 in chips) 
Seat 3: caduceus369 (€2.32 in chips) 
Seat 4: CarlaBBruni (€3.95 in chips) 
Seat 5: Temait77728 (€0.80 in chips) 
Seat 6: Warterror90 (€4.12 in chips) 
TheMule1454: posts small blind €0.01
caduceus369: posts big blind €0.02
*** HOLE CARDS ***
Dealt to caduceus369 [5c 8c]
CarlaBBruni: folds 
Temait77728: folds 
Warterror90: folds 
Crock361: raises €0.04 to €0.06
TheMule1454: calls €0.05
caduceus369: calls €0.04
*** FLOP *** [Jh 4d 8s]
TheMule1454: checks 
caduceus369: bets €0.04
Crock361: calls €0.04
TheMule1454: folds 
*** TURN *** [Jh 4d 8s] [6d]
caduceus369: checks 
Crock361: checks 
*** RIVER *** [Jh 4d 8s 6d] [3d]
caduceus369: bets €0.08
Crock361: calls €0.08
*** SHOW DOWN ***
caduceus369: shows [5c 8c] (a pair of Eights)
Crock361: shows [Td Ts] (a pair of Tens)
Crock361 collected €0.40 from pot
*** SUMMARY ***
Total pot €0.42 | Rake €0.02 
Board [Jh 4d 8s 6d 3d]
Seat 1: Crock361 (button) showed [Td Ts] and won (€0.40) with a pair of Tens
Seat 2: TheMule1454 (small blind) folded on the Flop
Seat 3: caduceus369 (big blind) showed [5c 8c] and lost with a pair of Eights
Seat 4: CarlaBBruni folded before Flop (didn't bet)
Seat 5: Temait77728 folded before Flop (didn't bet)
Seat 6: Warterror90 folded before Flop (didn't bet)



PokerStars Zoom Hand #258128924213:  Hold'em No Limit (€0.01/€0.02) [ADM ID: M62C63044C87BABT] - 2025/10/15 0:45:51 CET [2025/10/14 18:45:51 ET]
Table 'Sirio' 6-max Seat #1 is the button
Seat 1: franck19621962 (€1.80 in chips) 
Seat 2: caduceus369 (€2.14 in chips) 
Seat 3: Crock361 (€1.79 in chips) 
Seat 4: Warterror90 (€3.96 in chips) 
Seat 5: TheMule1454 (€1.27 in chips) 
Seat 6: SebaRapy14 (€3.09 in chips) 
caduceus369: posts small blind €0.01
Crock361: posts big blind €0.02
*** HOLE CARDS ***
Dealt to caduceus369 [4c Kh]
Warterror90: folds 
TheMule1454: raises €0.05 to €0.07
SebaRapy14: folds 
franck19621962: folds 
caduceus369: folds 
Crock361: folds 
Uncalled bet (€0.05) returned to TheMule1454
TheMule1454 collected €0.05 from pot
TheMule1454: doesn't show hand 
*** SUMMARY ***
Total pot €0.05 | Rake €0 
Seat 1: franck19621962 (button) folded before Flop (didn't bet)
Seat 2: caduceus369 (small blind) folded before Flop
Seat 3: Crock361 (big blind) folded before Flop
Seat 4: Warterror90 folded before Flop (didn't bet)
Seat 5: TheMule1454 collected (€0.05)
Seat 6: SebaRapy14 folded before Flop (didn't bet)



PokerStars Zoom Hand #258128925612:  Hold'em No Limit (€0.01/€0.02) [ADM ID: M62C63044C87BABT] - 2025/10/15 0:45:58 CET [2025/10/14 18:45:58 ET]
Table 'Sirio' 6-max Seat #1 is the button
Seat 1: aurelios2 (€9.03 in chips) 
Seat 2: Temait77728 (€0.82 in chips) 
Seat 3: Rrrr322 (€0.32 in chips) 
Seat 4: mashallahh (€2.84 in chips) 
Seat 5: caduceus369 (€2.13 in chips) 
Seat 6: 2PaperelaSgubio (€2.75 in chips) 
Temait77728: posts small blind €0.01
Rrrr322: posts big blind €0.02
*** HOLE CARDS ***
Dealt to caduceus369 [5h Ac]
mashallahh: folds 
aurelios2 is disconnected 
caduceus369: raises €0.04 to €0.06
2PaperelaSgubio: folds 
aurelios2 has timed out while disconnected
aurelios2: folds 
Temait77728: folds 
Rrrr322: calls €0.04
*** FLOP *** [Kh 7s Ts]
Rrrr322: checks 
caduceus369: checks 
*** TURN *** [Kh 7s Ts] [3h]
Rrrr322: checks 
caduceus369: checks 
*** RIVER *** [Kh 7s Ts 3h] [9h]
Rrrr322: bets €0.04
caduceus369: raises €0.06 to €0.10
Rrrr322: calls €0.06
*** SHOW DOWN ***
caduceus369: shows [5h Ac] (high card Ace)
Rrrr322: shows [Ah 8d] (high card Ace - King+Ten+Nine+Eight kicker)
Rrrr322 collected €0.32 from pot
*** SUMMARY ***
Total pot €0.33 | Rake €0.01 
Board [Kh 7s Ts 3h 9h]
Seat 1: aurelios2 (button) folded before Flop (didn't bet)
Seat 2: Temait77728 (small blind) folded before Flop
Seat 3: Rrrr322 (big blind) showed [Ah 8d] and won (€0.32) with high card Ace
Seat 4: mashallahh folded before Flop (didn't bet)
Seat 5: caduceus369 showed [5h Ac] and lost with high card Ace
Seat 6: 2PaperelaSgubio folded before Flop (didn't bet)



PokerStars Zoom Hand #258128939933:  Hold'em No Limit (€0.01/€0.02) [ADM ID: M62C63044C87BABT] - 2025/10/15 0:47:12 CET [2025/10/14 18:47:12 ET]
Table 'Sirio' 6-max Seat #1 is the button
Seat 1: Rrrr322 (€0.48 in chips) 
Seat 2: Agnese84 (€1.52 in chips) 
Seat 3: SebaRapy14 (€3.24 in chips) 
Seat 4: CarlaBBruni (€4.02 in chips) 
Seat 5: Catania838 (€3.37 in chips) 
Seat 6: caduceus369 (€2 in chips) 
Agnese84: posts small blind €0.01
SebaRapy14: posts big blind €0.02
*** HOLE CARDS ***
Dealt to caduceus369 [Ah Qd]
CarlaBBruni: folds 
Catania838: folds 
caduceus369: raises €0.04 to €0.06
Rrrr322: folds 
Agnese84: calls €0.05
SebaRapy14: calls €0.04
*** FLOP *** [Ts Td 3h]
Agnese84: checks 
SebaRapy14: checks 
caduceus369: checks 
*** TURN *** [Ts Td 3h] [5c]
Agnese84: bets €0.09
SebaRapy14: calls €0.09
caduceus369: folds 
*** RIVER *** [Ts Td 3h 5c] [Qc]
Agnese84: checks 
SebaRapy14: bets €0.32
Agnese84: folds 
Uncalled bet (€0.32) returned to SebaRapy14
SebaRapy14 collected €0.35 from pot
SebaRapy14: doesn't show hand 
*** SUMMARY ***
Total pot €0.36 | Rake €0.01 
Board [Ts Td 3h 5c Qc]
Seat 1: Rrrr322 (button) folded before Flop (didn't bet)
Seat 2: Agnese84 (small blind) folded on the River
Seat 3: SebaRapy14 (big blind) collected (€0.35)
Seat 4: CarlaBBruni folded before Flop (didn't bet)
Seat 5: Catania838 folded before Flop (didn't bet)
Seat 6: caduceus369 folded on the Turn



PokerStars Zoom Hand #258128945306:  Hold'em No Limit (€0.01/€0.02) [ADM ID: M62C63044C87BABT] - 2025/10/15 0:47:40 CET [2025/10/14 18:47:40 ET]
Table 'Sirio' 6-max Seat #1 is the button
Seat 1: caduceus369 (€2 in chips) 
Seat 2: McSup (€2.14 in chips) 
Seat 3: Warterror90 (€3.79 in chips) 
Seat 4: mashallahh (€8.44 in chips) 
Seat 5: CarlaBBruni (€1.96 in chips) 
Seat 6: TheMule1454 (€1.40 in chips) 
McSup: posts small blind €0.01
Warterror90: posts big blind €0.02
*** HOLE CARDS ***
Dealt to caduceus369 [2d 7d]
mashallahh: raises €0.04 to €0.06
CarlaBBruni: folds 
TheMule1454: raises €0.15 to €0.21
caduceus369: folds 
McSup: folds 
Warterror90: folds 
mashallahh: folds 
Uncalled bet (€0.15) returned to TheMule1454
TheMule1454 collected €0.15 from pot
TheMule1454: doesn't show hand 
*** SUMMARY ***
Total pot €0.15 | Rake €0 
Seat 1: caduceus369 (button) folded before Flop (didn't bet)
Seat 2: McSup (small blind) folded before Flop
Seat 3: Warterror90 (big blind) folded before Flop
Seat 4: mashallahh folded before Flop
Seat 5: CarlaBBruni folded before Flop (didn't bet)
Seat 6: TheMule1454 collected (€0.15)



PokerStars Zoom Hand #258128952549:  Hold'em No Limit (€0.01/€0.02) [ADM ID: M62C63044C87BABT] - 2025/10/15 0:48:19 CET [2025/10/14 18:48:19 ET]
Table 'Sirio' 6-max Seat #1 is the button
Seat 1: Warterror90 (€4.14 in chips) 
Seat 2: 2PaperelaSgubio (€2.59 in chips) 
Seat 3: mashallahh (€6.90 in chips) 
Seat 4: caduceus369 (€2 in chips) 
Seat 5: franck19621962 (€1.91 in chips) 
Seat 6: meteco79 (€1.26 in chips) 
2PaperelaSgubio: posts small blind €0.01
mashallahh: posts big blind €0.02
*** HOLE CARDS ***
Dealt to caduceus369 [6h 4d]
caduceus369: folds 
franck19621962: folds 
meteco79: folds 
Warterror90: raises €0.04 to €0.06
2PaperelaSgubio: folds 
mashallahh: folds 
Uncalled bet (€0.04) returned to Warterror90
Warterror90 collected €0.05 from pot
Warterror90: doesn't show hand 
*** SUMMARY ***
Total pot €0.05 | Rake €0 
Seat 1: Warterror90 (button) collected (€0.05)
Seat 2: 2PaperelaSgubio (small blind) folded before Flop
Seat 3: mashallahh (big blind) folded before Flop
Seat 4: caduceus369 folded before Flop (didn't bet)
Seat 5: franck19621962 folded before Flop (didn't bet)
Seat 6: meteco79 folded before Flop (didn't bet)



PokerStars Zoom Hand #258128946347:  Hold'em No Limit (€0.01/€0.02) [ADM ID: M62C63044C87BABT] - 2025/10/15 0:47:46 CET [2025/10/14 18:47:46 ET]
Table 'Sirio' 6-max Seat #1 is the button
Seat 1: Catania838 (€3.35 in chips) 
Seat 2: Warterror90 (€3.77 in chips) 
Seat 3: caduceus369 (€2 in chips) 
Seat 4: Alifatti (€0.55 in chips) 
Seat 5: McSup (€2.13 in chips) 
Seat 6: Poetto65 (€0.84 in chips) 
Warterror90: posts small blind €0.01
caduceus369: posts big blind €0.02
*** HOLE CARDS ***
Dealt to caduceus369 [7d 8s]
Alifatti: calls €0.02
McSup: calls €0.02
Poetto65: folds 
Catania838: calls €0.02
Warterror90: folds 
caduceus369: checks 
*** FLOP *** [9d Qs 2h]
caduceus369: checks 
Alifatti: checks 
McSup: bets €0.05
Catania838: calls €0.05
caduceus369: folds 
Alifatti: folds 
*** TURN *** [9d Qs 2h] [Kc]
McSup: bets €0.09
Catania838: calls €0.09
*** RIVER *** [9d Qs 2h Kc] [5c]
McSup: bets €0.22
Catania838: raises €0.40 to €0.62
McSup: calls €0.40
*** SHOW DOWN ***
Catania838: shows [Jc Th] (a straight, Nine to King)
McSup: mucks hand 
Catania838 collected €1.53 from pot
*** SUMMARY ***
Total pot €1.61 | Rake €0.08 
Board [9d Qs 2h Kc 5c]
Seat 1: Catania838 (button) showed [Jc Th] and won (€1.53) with a straight, Nine to King
Seat 2: Warterror90 (small blind) folded before Flop
Seat 3: caduceus369 (big blind) folded on the Flop
Seat 4: Alifatti folded on the Flop
Seat 5: McSup mucked [Ks Qc]
Seat 6: Poetto65 folded before Flop (didn't bet)



PokerStars Zoom Hand #258128955504:  Hold'em No Limit (€0.01/€0.02) [ADM ID: M62C63044C87BABT] - 2025/10/15 0:48:34 CET [2025/10/14 18:48:34 ET]
Table 'Sirio' 6-max Seat #1 is the button
Seat 1: CarlaBBruni (€3.94 in chips) 
Seat 2: franck19621962 (€1.89 in chips) 
Seat 3: Crock361 (€2.24 in chips) 
Seat 4: TheMule1454 (€0.87 in chips) 
Seat 5: Freddy15081988 (€1 in chips) 
Seat 6: caduceus369 (€2 in chips) 
franck19621962: posts small blind €0.01
Crock361: posts big blind €0.02
*** HOLE CARDS ***
Dealt to caduceus369 [2h 5c]
TheMule1454: folds 
Freddy15081988: folds 
caduceus369: folds 
CarlaBBruni: raises €0.03 to €0.05
franck19621962: folds 
Crock361: folds 
Uncalled bet (€0.03) returned to CarlaBBruni
CarlaBBruni collected €0.05 from pot
CarlaBBruni: doesn't show hand 
*** SUMMARY ***
Total pot €0.05 | Rake €0 
Seat 1: CarlaBBruni (button) collected (€0.05)
Seat 2: franck19621962 (small blind) folded before Flop
Seat 3: Crock361 (big blind) folded before Flop
Seat 4: TheMule1454 folded before Flop (didn't bet)
Seat 5: Freddy15081988 folded before Flop (didn't bet)
Seat 6: caduceus369 folded before Flop (didn't bet)



PokerStars Zoom Hand #258128956402:  Hold'em No Limit (€0.01/€0.02) [ADM ID: M62C63044C87BABT] - 2025/10/15 0:48:39 CET [2025/10/14 18:48:39 ET]
Table 'Sirio' 6-max Seat #1 is the button
Seat 1: Freddy15081988 (€1 in chips) 
Seat 2: Crock361 (€1.95 in chips) 
Seat 3: CarlaBBruni (€1.90 in chips) 
Seat 4: mashallahh (€6.88 in chips) 
Seat 5: caduceus369 (€2 in chips) 
Seat 6: TheMule1454 (€3.05 in chips) 
Crock361: posts small blind €0.01
CarlaBBruni: posts big blind €0.02
*** HOLE CARDS ***
Dealt to caduceus369 [Jc 7s]
mashallahh: folds 
caduceus369: folds 
TheMule1454: folds 
Freddy15081988: folds 
Crock361: raises €0.04 to €0.06
CarlaBBruni: folds 
Uncalled bet (€0.04) returned to Crock361
Crock361 collected €0.04 from pot
Crock361: doesn't show hand 
*** SUMMARY ***
Total pot €0.04 | Rake €0 
Seat 1: Freddy15081988 (button) folded before Flop (didn't bet)
Seat 2: Crock361 (small blind) collected (€0.04)
Seat 3: CarlaBBruni (big blind) folded before Flop
Seat 4: mashallahh folded before Flop (didn't bet)
Seat 5: caduceus369 folded before Flop (didn't bet)
Seat 6: TheMule1454 folded before Flop (didn't bet)



PokerStars Zoom Hand #258128953340:  Hold'em No Limit (€0.01/€0.02) [ADM ID: M62C63044C87BABT] - 2025/10/15 0:48:23 CET [2025/10/14 18:48:23 ET]
Table 'Sirio' 6-max Seat #1 is the button
Seat 1: mashallahh (€5.54 in chips) 
Seat 2: caduceus369 (€2 in chips) 
Seat 3: Alifatti (€0.53 in chips) 
Seat 4: gigiriver170 (€1.06 in chips) 
Seat 5: Warterror90 (€3.79 in chips) 
Seat 6: Crock361 (€1.95 in chips) 
caduceus369: posts small blind €0.01
Alifatti: posts big blind €0.02
*** HOLE CARDS ***
Dealt to caduceus369 [Kh 7s]
gigiriver170: calls €0.02
Warterror90: folds 
Crock361: folds 
mashallahh: folds 
caduceus369: folds 
Alifatti: checks 
*** FLOP *** [Kc 4d Ks]
Alifatti: checks 
gigiriver170: checks 
*** TURN *** [Kc 4d Ks] [Ah]
Alifatti: checks 
gigiriver170: checks 
*** RIVER *** [Kc 4d Ks Ah] [7h]
Alifatti: bets €0.02
gigiriver170: raises €0.05 to €0.07
Alifatti: calls €0.05
*** SHOW DOWN ***
gigiriver170: shows [As 9c] (two pair, Aces and Kings)
Alifatti: mucks hand 
gigiriver170 collected €0.18 from pot
*** SUMMARY ***
Total pot €0.19 | Rake €0.01 
Board [Kc 4d Ks Ah 7h]
Seat 1: mashallahh (button) folded before Flop (didn't bet)
Seat 2: caduceus369 (small blind) folded before Flop
Seat 3: Alifatti (big blind) mucked [4s 5s]
Seat 4: gigiriver170 showed [As 9c] and won (€0.18) with two pair, Aces and Kings
Seat 5: Warterror90 folded before Flop (didn't bet)
Seat 6: Crock361 folded before Flop (didn't bet)



PokerStars Zoom Hand #258128957811:  Hold'em No Limit (€0.01/€0.02) [ADM ID: M62C63044C87BABT] - 2025/10/15 0:48:46 CET [2025/10/14 18:48:46 ET]
Table 'Sirio' 6-max Seat #1 is the button
Seat 1: caduceus369 (€2 in chips) 
Seat 2: CIKO71131 (€0.78 in chips) 
Seat 3: 2PaperelaSgubio (€2.58 in chips) 
Seat 4: TheMule1454 (€0.87 in chips) 
Seat 5: mashallahh (€5.53 in chips) 
Seat 6: Freddy15081988 (€1 in chips) 
CIKO71131: posts small blind €0.01
2PaperelaSgubio: posts big blind €0.02
*** HOLE CARDS ***
Dealt to caduceus369 [8d 3d]
TheMule1454: folds 
mashallahh: folds 
Freddy15081988: folds 
caduceus369: folds 
CIKO71131: calls €0.01
2PaperelaSgubio: raises €0.06 to €0.08
CIKO71131: folds 
Uncalled bet (€0.06) returned to 2PaperelaSgubio
2PaperelaSgubio collected €0.04 from pot
2PaperelaSgubio: doesn't show hand 
*** SUMMARY ***
Total pot €0.04 | Rake €0 
Seat 1: caduceus369 (button) folded before Flop (didn't bet)
Seat 2: CIKO71131 (small blind) folded before Flop
Seat 3: 2PaperelaSgubio (big blind) collected (€0.04)
Seat 4: TheMule1454 folded before Flop (didn't bet)
Seat 5: mashallahh folded before Flop (didn't bet)
Seat 6: Freddy15081988 folded before Flop (didn't bet)



PokerStars Zoom Hand #258128959014:  Hold'em No Limit (€0.01/€0.02) [ADM ID: M62C63044C87BABT] - 2025/10/15 0:48:53 CET [2025/10/14 18:48:53 ET]
Table 'Sirio' 6-max Seat #1 is the button
Seat 1: Crock361 (€1.97 in chips) 
Seat 2: Freddy15081988 (€1 in chips) 
Seat 3: caduceus369 (€2 in chips) 
Seat 4: TheMule1454 (€3.05 in chips) 
Seat 5: CarlaBBruni (€3.97 in chips) 
Seat 6: mashallahh (€5.53 in chips) 
Freddy15081988: posts small blind €0.01
caduceus369: posts big blind €0.02
*** HOLE CARDS ***
Dealt to caduceus369 [As 9h]
TheMule1454: folds 
CarlaBBruni: folds 
mashallahh: raises €0.04 to €0.06
Crock361: folds 
Freddy15081988: calls €0.05
caduceus369: calls €0.04
*** FLOP *** [Tc Qc Ks]
Freddy15081988: checks 
caduceus369: checks 
mashallahh: checks 
*** TURN *** [Tc Qc Ks] [7c]
Freddy15081988: bets €0.09
caduceus369: folds 
mashallahh: folds 
Uncalled bet (€0.09) returned to Freddy15081988
Freddy15081988 collected €0.18 from pot
Freddy15081988: doesn't show hand 
*** SUMMARY ***
Total pot €0.18 | Rake €0 
Board [Tc Qc Ks 7c]
Seat 1: Crock361 (button) folded before Flop (didn't bet)
Seat 2: Freddy15081988 (small blind) collected (€0.18)
Seat 3: caduceus369 (big blind) folded on the Turn
Seat 4: TheMule1454 folded before Flop (didn't bet)
Seat 5: CarlaBBruni folded before Flop (didn't bet)
Seat 6: mashallahh folded on the Turn



PokerStars Zoom Hand #258128966737:  Hold'em No Limit (€0.01/€0.02) [ADM ID: M62C63044C87BABT] - 2025/10/15 0:49:34 CET [2025/10/14 18:49:34 ET]
Table 'Sirio' 6-max Seat #1 is the button
Seat 1: McSup (€1.41 in chips) 
Seat 2: Crock361 (€2.58 in chips) 
Seat 3: CarlaBBruni (€1.87 in chips) 
Seat 4: caduceus369 (€2 in chips) 
Seat 5: Warterror90 (€6.30 in chips) 
Seat 6: TheMule1454 (€1.22 in chips) 
Crock361: posts small blind €0.01
CarlaBBruni: posts big blind €0.02
*** HOLE CARDS ***
Dealt to caduceus369 [Js 8h]
caduceus369: folds 
Warterror90: folds 
TheMule1454: raises €0.04 to €0.06
McSup: folds 
Crock361: folds 
CarlaBBruni: folds 
Uncalled bet (€0.04) returned to TheMule1454
TheMule1454 collected €0.05 from pot
TheMule1454: doesn't show hand 
*** SUMMARY ***
Total pot €0.05 | Rake €0 
Seat 1: McSup (button) folded before Flop (didn't bet)
Seat 2: Crock361 (small blind) folded before Flop
Seat 3: CarlaBBruni (big blind) folded before Flop
Seat 4: caduceus369 folded before Flop (didn't bet)
Seat 5: Warterror90 folded before Flop (didn't bet)
Seat 6: TheMule1454 collected (€0.05)



PokerStars Zoom Hand #258128967462:  Hold'em No Limit (€0.01/€0.02) [ADM ID: M62C63044C87BABT] - 2025/10/15 0:49:38 CET [2025/10/14 18:49:38 ET]
Table 'Sirio' 6-max Seat #1 is the button
Seat 1: TheBullOfPoker (€2 in chips) 
Seat 2: TheMule1454 (€3.05 in chips) 
Seat 3: EasyToRule (€2 in chips) 
Seat 4: mashallahh (€6.87 in chips) 
Seat 5: caduceus369 (€2 in chips) 
Seat 6: 2PaperelaSgubio (€2.66 in chips) 
TheMule1454: posts small blind €0.01
EasyToRule: posts big blind €0.02
*** HOLE CARDS ***
Dealt to caduceus369 [9s 3d]
mashallahh: folds 
caduceus369: folds 
2PaperelaSgubio: folds 
TheBullOfPoker: folds 
TheMule1454: folds 
Uncalled bet (€0.01) returned to EasyToRule
EasyToRule collected €0.02 from pot
EasyToRule: doesn't show hand 
*** SUMMARY ***
Total pot €0.02 | Rake €0 
Seat 1: TheBullOfPoker (button) folded before Flop (didn't bet)
Seat 2: TheMule1454 (small blind) folded before Flop
Seat 3: EasyToRule (big blind) collected (€0.02)
Seat 4: mashallahh folded before Flop (didn't bet)
Seat 5: caduceus369 folded before Flop (didn't bet)
Seat 6: 2PaperelaSgubio folded before Flop (didn't bet)



PokerStars Zoom Hand #258128970450:  Hold'em No Limit (€0.01/€0.02) [ADM ID: M62C63044C87BABT] - 2025/10/15 0:49:54 CET [2025/10/14 18:49:54 ET]
Table 'Sirio' 6-max Seat #1 is the button
Seat 1: Temait77728 (€1.03 in chips) 
Seat 2: caduceus369 (€2 in chips) 
Seat 3: father2008 (€2.06 in chips) 
Seat 4: mashallahh (€2.79 in chips) 
Seat 5: TheBullOfPoker (€2 in chips) 
Seat 6: EasyToRule (€2.01 in chips) 
caduceus369: posts small blind €0.01
father2008: posts big blind €0.02
*** HOLE CARDS ***
Dealt to caduceus369 [2d 9h]
mashallahh: folds 
TheBullOfPoker: folds 
EasyToRule: raises €0.03 to €0.05
Temait77728: folds 
caduceus369: folds 
father2008: folds 
Uncalled bet (€0.03) returned to EasyToRule
EasyToRule collected €0.05 from pot
EasyToRule: doesn't show hand 
*** SUMMARY ***
Total pot €0.05 | Rake €0 
Seat 1: Temait77728 (button) folded before Flop (didn't bet)
Seat 2: caduceus369 (small blind) folded before Flop
Seat 3: father2008 (big blind) folded before Flop
Seat 4: mashallahh folded before Flop (didn't bet)
Seat 5: TheBullOfPoker folded before Flop (didn't bet)
Seat 6: EasyToRule collected (€0.05)



PokerStars Zoom Hand #258128969338:  Hold'em No Limit (€0.01/€0.02) [ADM ID: M62C63044C87BABT] - 2025/10/15 0:49:48 CET [2025/10/14 18:49:48 ET]
Table 'Sirio' 6-max Seat #1 is the button
Seat 1: caduceus369 (€2 in chips) 
Seat 2: CarlaBBruni (€1.85 in chips) 
Seat 3: Rrrr322 (€1 in chips) 
Seat 4: McSup (€1.41 in chips) 
Seat 5: TheMule1454 (€1.25 in chips) 
Seat 6: TheBullOfPoker (€2 in chips) 
CarlaBBruni: posts small blind €0.01
Rrrr322: posts big blind €0.02
*** HOLE CARDS ***
Dealt to caduceus369 [5d 6h]
McSup: raises €0.02 to €0.04
TheMule1454: folds 
TheBullOfPoker: folds 
caduceus369: folds 
CarlaBBruni: folds 
Rrrr322: calls €0.02
*** FLOP *** [2s 8s 8h]
Rrrr322: checks 
McSup: bets €0.05
Rrrr322: calls €0.05
*** TURN *** [2s 8s 8h] [8c]
Rrrr322: checks 
McSup: bets €0.09
Rrrr322: raises €0.82 to €0.91 and is all-in
McSup: folds 
Uncalled bet (€0.82) returned to Rrrr322
Rrrr322 collected €0.35 from pot
Rrrr322: doesn't show hand 
*** SUMMARY ***
Total pot €0.37 | Rake €0.02 
Board [2s 8s 8h 8c]
Seat 1: caduceus369 (button) folded before Flop (didn't bet)
Seat 2: CarlaBBruni (small blind) folded before Flop
Seat 3: Rrrr322 (big blind) collected (€0.35)
Seat 4: McSup folded on the Turn
Seat 5: TheMule1454 folded before Flop (didn't bet)
Seat 6: TheBullOfPoker folded before Flop (didn't bet)



PokerStars Zoom Hand #258128971638:  Hold'em No Limit (€0.01/€0.02) [ADM ID: M62C63044C87BABT] - 2025/10/15 0:50:00 CET [2025/10/14 18:50:00 ET]
Table 'Sirio' 6-max Seat #1 is the button
Seat 1: Trezvenik93 (€2 in chips) 
Seat 2: mashallahh (€2.79 in chips) 
Seat 3: caduceus369 (€2 in chips) 
Seat 4: This Heat (€1.47 in chips) 
Seat 5: Warterror90 (€2.60 in chips) 
Seat 6: Crock361 (€1.97 in chips) 
mashallahh: posts small blind €0.01
caduceus369: posts big blind €0.02
*** HOLE CARDS ***
Dealt to caduceus369 [3h Jh]
This Heat: raises €0.04 to €0.06
Warterror90: folds 
Crock361: folds 
Trezvenik93: folds 
mashallahh: folds 
caduceus369: calls €0.04
*** FLOP *** [7s Ah 2h]
caduceus369: checks 
This Heat: bets €0.07
caduceus369: calls €0.07
*** TURN *** [7s Ah 2h] [Th]
caduceus369: checks 
This Heat: bets €0.13
caduceus369: calls €0.13
*** RIVER *** [7s Ah 2h Th] [8s]
caduceus369: bets €0.64
This Heat: folds 
Uncalled bet (€0.64) returned to caduceus369
caduceus369 collected €0.51 from pot
caduceus369: doesn't show hand 
*** SUMMARY ***
Total pot €0.53 | Rake €0.02 
Board [7s Ah 2h Th 8s]
Seat 1: Trezvenik93 (button) folded before Flop (didn't bet)
Seat 2: mashallahh (small blind) folded before Flop
Seat 3: caduceus369 (big blind) collected (€0.51)
Seat 4: This Heat folded on the River
Seat 5: Warterror90 folded before Flop (didn't bet)
Seat 6: Crock361 folded before Flop (didn't bet)



PokerStars Zoom Hand #258128986298:  Hold'em No Limit (€0.01/€0.02) [ADM ID: M62C63044C87BABT] - 2025/10/15 0:51:19 CET [2025/10/14 18:51:19 ET]
Table 'Sirio' 6-max Seat #1 is the button
Seat 1: This Heat (€1.21 in chips) 
Seat 2: Trezvenik93 (€2.01 in chips) 
Seat 3: mashallahh (€6.84 in chips) 
Seat 4: EasyToRule (€2.03 in chips) 
Seat 5: il_jack$$$58 (€1.94 in chips) 
Seat 6: caduceus369 (€2.25 in chips) 
Trezvenik93: posts small blind €0.01
mashallahh: posts big blind €0.02
*** HOLE CARDS ***
Dealt to caduceus369 [5d 2d]
EasyToRule: folds 
il_jack$$$58: raises €0.03 to €0.05
caduceus369: folds 
This Heat: folds 
Trezvenik93: calls €0.04
mashallahh: folds 
*** FLOP *** [5s Kd Ah]
Trezvenik93: checks 
il_jack$$$58: bets €0.06
Trezvenik93: folds 
Uncalled bet (€0.06) returned to il_jack$$$58
il_jack$$$58 collected €0.12 from pot
il_jack$$$58: doesn't show hand 
*** SUMMARY ***
Total pot €0.12 | Rake €0 
Board [5s Kd Ah]
Seat 1: This Heat (button) folded before Flop (didn't bet)
Seat 2: Trezvenik93 (small blind) folded on the Flop
Seat 3: mashallahh (big blind) folded before Flop
Seat 4: EasyToRule folded before Flop (didn't bet)
Seat 5: il_jack$$$58 collected (€0.12)
Seat 6: caduceus369 folded before Flop (didn't bet)



PokerStars Zoom Hand #258128988026:  Hold'em No Limit (€0.01/€0.02) [ADM ID: M62C63044C87BABT] - 2025/10/15 0:51:29 CET [2025/10/14 18:51:29 ET]
Table 'Sirio' 6-max Seat #1 is the button
Seat 1: Agnese84 (€1.44 in chips) 
Seat 2: mashallahh (€6.82 in chips) 
Seat 3: franck19621962 (€0.76 in chips) 
Seat 4: TheMule1454 (€3.19 in chips) 
Seat 5: caduceus369 (€2.25 in chips) 
Seat 6: 2PaperelaSgubio (€2.84 in chips) 
mashallahh: posts small blind €0.01
franck19621962: posts big blind €0.02
*** HOLE CARDS ***
Dealt to caduceus369 [Qs Ah]
TheMule1454: folds 
caduceus369: raises €0.04 to €0.06
2PaperelaSgubio: folds 
Agnese84: calls €0.06
mashallahh: raises €0.20 to €0.26
franck19621962: folds 
caduceus369: raises €0.48 to €0.74
Agnese84: folds 
mashallahh: calls €0.48
*** FLOP *** [Tc Qd Jc]
mashallahh: checks 
caduceus369: bets €1.51 and is all-in
mashallahh: calls €1.51
*** TURN *** [Tc Qd Jc] [3h]
*** RIVER *** [Tc Qd Jc 3h] [7d]
*** SHOW DOWN ***
mashallahh: shows [Kc Ad] (a straight, Ten to Ace)
caduceus369: shows [Qs Ah] (a pair of Queens)
mashallahh collected €4.33 from pot
*** SUMMARY ***
Total pot €4.58 | Rake €0.25 
Board [Tc Qd Jc 3h 7d]
Seat 1: Agnese84 (button) folded before Flop
Seat 2: mashallahh (small blind) showed [Kc Ad] and won (€4.33) with a straight, Ten to Ace
Seat 3: franck19621962 (big blind) folded before Flop
Seat 4: TheMule1454 folded before Flop (didn't bet)
Seat 5: caduceus369 showed [Qs Ah] and lost with a pair of Queens
Seat 6: 2PaperelaSgubio folded before Flop (didn't bet)



PokerStars Zoom Hand #258129002348:  Hold'em No Limit (€0.01/€0.02) [ADM ID: M62C63044C87BABT] - 2025/10/15 0:52:47 CET [2025/10/14 18:52:47 ET]
Table 'Sirio' 6-max Seat #1 is the button
Seat 1: EasyToRule (€2 in chips) 
Seat 2: caduceus369 (€2 in chips) 
Seat 3: Warterror90 (€3.03 in chips) 
Seat 4: CarlaBBruni (€1.92 in chips) 
Seat 5: father2008 (€2.20 in chips) 
Seat 6: TheMule1454 (€2.98 in chips) 
caduceus369: posts small blind €0.01
Warterror90: posts big blind €0.02
*** HOLE CARDS ***
Dealt to caduceus369 [2c 3h]
CarlaBBruni: folds 
father2008: folds 
TheMule1454: folds 
EasyToRule: folds 
caduceus369: folds 
Uncalled bet (€0.01) returned to Warterror90
Warterror90 collected €0.02 from pot
Warterror90: doesn't show hand 
*** SUMMARY ***
Total pot €0.02 | Rake €0 
Seat 1: EasyToRule (button) folded before Flop (didn't bet)
Seat 2: caduceus369 (small blind) folded before Flop
Seat 3: Warterror90 (big blind) collected (€0.02)
Seat 4: CarlaBBruni folded before Flop (didn't bet)
Seat 5: father2008 folded before Flop (didn't bet)
Seat 6: TheMule1454 folded before Flop (didn't bet)



PokerStars Zoom Hand #258129000886:  Hold'em No Limit (€0.01/€0.02) [ADM ID: M62C63044C87BABT] - 2025/10/15 0:52:39 CET [2025/10/14 18:52:39 ET]
Table 'Sirio' 6-max Seat #1 is the button
Seat 1: mashallahh (€8.90 in chips) 
Seat 2: Alifatti (€0.99 in chips) 
Seat 3: QUEEN-KING-QQKK (€3.14 in chips) 
Seat 4: caduceus369 (€2 in chips) 
Seat 5: father2008 (€2.20 in chips) 
Seat 6: TheMule1454 (€1.06 in chips) 
Alifatti: posts small blind €0.01
QUEEN-KING-QQKK: posts big blind €0.02
*** HOLE CARDS ***
Dealt to caduceus369 [6c 5c]
caduceus369: folds 
father2008: folds 
TheMule1454: folds 
mashallahh: folds 
Alifatti: calls €0.01
QUEEN-KING-QQKK: checks 
*** FLOP *** [As 3d 2s]
Alifatti: checks 
QUEEN-KING-QQKK: checks 
*** TURN *** [As 3d 2s] [3s]
Alifatti: checks 
QUEEN-KING-QQKK: checks 
*** RIVER *** [As 3d 2s 3s] [2c]
Alifatti: checks 
QUEEN-KING-QQKK: bets €0.02
Alifatti: calls €0.02
*** SHOW DOWN ***
QUEEN-KING-QQKK: shows [Td Th] (two pair, Tens and Threes)
Alifatti: mucks hand 
QUEEN-KING-QQKK collected €0.08 from pot
*** SUMMARY ***
Total pot €0.08 | Rake €0 
Board [As 3d 2s 3s 2c]
Seat 1: mashallahh (button) folded before Flop (didn't bet)
Seat 2: Alifatti (small blind) mucked [8h Qh]
Seat 3: QUEEN-KING-QQKK (big blind) showed [Td Th] and won (€0.08) with two pair, Tens and Threes
Seat 4: caduceus369 folded before Flop (didn't bet)
Seat 5: father2008 folded before Flop (didn't bet)
Seat 6: TheMule1454 folded before Flop (didn't bet)



PokerStars Zoom Hand #258129003430:  Hold'em No Limit (€0.01/€0.02) [ADM ID: M62C63044C87BABT] - 2025/10/15 0:52:53 CET [2025/10/14 18:52:53 ET]
Table 'Sirio' 6-max Seat #1 is the button
Seat 1: father2008 (€2.20 in chips) 
Seat 2: Temait77728 (€1.67 in chips) 
Seat 3: meteco79 (€1.07 in chips) 
Seat 4: mashallahh (€8.90 in chips) 
Seat 5: CarlaBBruni (€4.46 in chips) 
Seat 6: caduceus369 (€2 in chips) 
Temait77728: posts small blind €0.01
meteco79: posts big blind €0.02
*** HOLE CARDS ***
Dealt to caduceus369 [3d 5s]
mashallahh: folds 
CarlaBBruni: folds 
caduceus369: folds 
father2008: raises €0.04 to €0.06
Temait77728: folds 
meteco79: folds 
Uncalled bet (€0.04) returned to father2008
father2008 collected €0.05 from pot
father2008: doesn't show hand 
*** SUMMARY ***
Total pot €0.05 | Rake €0 
Seat 1: father2008 (button) collected (€0.05)
Seat 2: Temait77728 (small blind) folded before Flop
Seat 3: meteco79 (big blind) folded before Flop
Seat 4: mashallahh folded before Flop (didn't bet)
Seat 5: CarlaBBruni folded before Flop (didn't bet)
Seat 6: caduceus369 folded before Flop (didn't bet)



PokerStars Zoom Hand #258129004948:  Hold'em No Limit (€0.01/€0.02) [ADM ID: M62C63044C87BABT] - 2025/10/15 0:53:01 CET [2025/10/14 18:53:01 ET]
Table 'Sirio' 6-max Seat #1 is the button
Seat 1: QUEEN-KING-QQKK (€1.88 in chips) 
Seat 2: caduceus369 (€2 in chips) 
Seat 3: franck19621962 (€0.63 in chips) 
Seat 4: CIKO71131 (€1.68 in chips) 
Seat 5: Temait77728 (€1.66 in chips) 
Seat 6: 2PaperelaSgubio (€2.12 in chips) 
caduceus369: posts small blind €0.01
franck19621962: posts big blind €0.02
*** HOLE CARDS ***
Dealt to caduceus369 [7d 4d]
CIKO71131: folds 
Temait77728: folds 
2PaperelaSgubio: raises €0.03 to €0.05
QUEEN-KING-QQKK: folds 
caduceus369: folds 
franck19621962: folds 
Uncalled bet (€0.03) returned to 2PaperelaSgubio
2PaperelaSgubio collected €0.05 from pot
2PaperelaSgubio: doesn't show hand 
*** SUMMARY ***
Total pot €0.05 | Rake €0 
Seat 1: QUEEN-KING-QQKK (button) folded before Flop (didn't bet)
Seat 2: caduceus369 (small blind) folded before Flop
Seat 3: franck19621962 (big blind) folded before Flop
Seat 4: CIKO71131 folded before Flop (didn't bet)
Seat 5: Temait77728 folded before Flop (didn't bet)
Seat 6: 2PaperelaSgubio collected (€0.05)



PokerStars Zoom Hand #258129007341:  Hold'em No Limit (€0.01/€0.02) [ADM ID: M62C63044C87BABT] - 2025/10/15 0:53:14 CET [2025/10/14 18:53:14 ET]
Table 'Sirio' 6-max Seat #1 is the button
Seat 1: Agnese84 (€0.73 in chips) 
Seat 2: ADRIAN0_MEIS (€5 in chips) 
Seat 3: caduceus369 (€2 in chips) 
Seat 4: CarlaBBruni (€4.46 in chips) 
Seat 5: Crock361 (€2.84 in chips) 
Seat 6: father2008 (€2.23 in chips) 
ADRIAN0_MEIS: posts small blind €0.01
caduceus369: posts big blind €0.02
*** HOLE CARDS ***
Dealt to caduceus369 [6d Kd]
CarlaBBruni: folds 
Crock361: raises €0.04 to €0.06
father2008: calls €0.06
Agnese84: folds 
ADRIAN0_MEIS: raises €0.17 to €0.23
caduceus369: folds 
Crock361: calls €0.17
father2008: calls €0.17
*** FLOP *** [Ac Js 6s]
ADRIAN0_MEIS: bets €0.37
Crock361: folds 
father2008: folds 
Uncalled bet (€0.37) returned to ADRIAN0_MEIS
ADRIAN0_MEIS collected €0.68 from pot
ADRIAN0_MEIS: doesn't show hand 
*** SUMMARY ***
Total pot €0.71 | Rake €0.03 
Board [Ac Js 6s]
Seat 1: Agnese84 (button) folded before Flop (didn't bet)
Seat 2: ADRIAN0_MEIS (small blind) collected (€0.68)
Seat 3: caduceus369 (big blind) folded before Flop
Seat 4: CarlaBBruni folded before Flop (didn't bet)
Seat 5: Crock361 folded on the Flop
Seat 6: father2008 folded on the Flop



PokerStars Zoom Hand #258129010534:  Hold'em No Limit (€0.01/€0.02) [ADM ID: M62C63044C87BABT] - 2025/10/15 0:53:32 CET [2025/10/14 18:53:32 ET]
Table 'Sirio' 6-max Seat #1 is the button
Seat 1: caduceus369 (€2 in chips) 
Seat 2: Freddy15081988 (€0.90 in chips) 
Seat 3: Begimon (€11.69 in chips) 
Seat 4: TheMule1454 (€3.28 in chips) 
Seat 5: Rrrr322 (€2.34 in chips) 
Seat 6: Warterror90 (€4.54 in chips) 
Freddy15081988: posts small blind €0.01
Begimon: posts big blind €0.02
*** HOLE CARDS ***
Dealt to caduceus369 [Ad 8d]
TheMule1454: folds 
Rrrr322: calls €0.02
Warterror90: folds 
caduceus369: raises €0.04 to €0.06
Freddy15081988: folds 
Begimon: calls €0.04
Rrrr322: calls €0.04
*** FLOP *** [Jd 6c 5h]
Begimon: checks 
Rrrr322: checks 
caduceus369: checks 
*** TURN *** [Jd 6c 5h] [7d]
Begimon: bets €0.02
Rrrr322: calls €0.02
caduceus369: calls €0.02
*** RIVER *** [Jd 6c 5h 7d] [Qs]
Begimon: bets €0.02
Rrrr322: raises €0.08 to €0.10
caduceus369: folds 
Begimon: folds 
Uncalled bet (€0.08) returned to Rrrr322
Rrrr322 collected €0.28 from pot
Rrrr322: doesn't show hand 
*** SUMMARY ***
Total pot €0.29 | Rake €0.01 
Board [Jd 6c 5h 7d Qs]
Seat 1: caduceus369 (button) folded on the River
Seat 2: Freddy15081988 (small blind) folded before Flop
Seat 3: Begimon (big blind) folded on the River
Seat 4: TheMule1454 folded before Flop (didn't bet)
Seat 5: Rrrr322 collected (€0.28)
Seat 6: Warterror90 folded before Flop (didn't bet)



PokerStars Zoom Hand #258129017677:  Hold'em No Limit (€0.01/€0.02) [ADM ID: M62C63044C87BABT] - 2025/10/15 0:54:11 CET [2025/10/14 18:54:11 ET]
Table 'Sirio' 6-max Seat #1 is the button
Seat 1: CarlaBBruni (€4.43 in chips) 
Seat 2: QUEEN-KING-QQKK (€1.78 in chips) 
Seat 3: father2008 (€2 in chips) 
Seat 4: Begimon (€11.59 in chips) 
Seat 5: caduceus369 (€2 in chips) 
Seat 6: ADRIAN0_MEIS (€5.50 in chips) 
QUEEN-KING-QQKK: posts small blind €0.01
father2008: posts big blind €0.02
*** HOLE CARDS ***
Dealt to caduceus369 [3d Qc]
Begimon: folds 
caduceus369: folds 
ADRIAN0_MEIS: folds 
CarlaBBruni: raises €0.03 to €0.05
QUEEN-KING-QQKK: folds 
father2008: folds 
Uncalled bet (€0.03) returned to CarlaBBruni
CarlaBBruni collected €0.05 from pot
CarlaBBruni: doesn't show hand 
*** SUMMARY ***
Total pot €0.05 | Rake €0 
Seat 1: CarlaBBruni (button) collected (€0.05)
Seat 2: QUEEN-KING-QQKK (small blind) folded before Flop
Seat 3: father2008 (big blind) folded before Flop
Seat 4: Begimon folded before Flop (didn't bet)
Seat 5: caduceus369 folded before Flop (didn't bet)
Seat 6: ADRIAN0_MEIS folded before Flop (didn't bet)



PokerStars Zoom Hand #258129016229:  Hold'em No Limit (€0.01/€0.02) [ADM ID: M62C63044C87BABT] - 2025/10/15 0:54:03 CET [2025/10/14 18:54:03 ET]
Table 'Sirio' 6-max Seat #1 is the button
Seat 1: Warterror90 (€7.04 in chips) 
Seat 2: CarlaBBruni (€4.44 in chips) 
Seat 3: CIKO71131 (€0.80 in chips) 
Seat 4: McSup (€1.83 in chips) 
Seat 5: QUEEN-KING-QQKK (€3.20 in chips) 
Seat 6: caduceus369 (€2 in chips) 
CarlaBBruni: posts small blind €0.01
CIKO71131: posts big blind €0.02
*** HOLE CARDS ***
Dealt to caduceus369 [4c 7c]
McSup: raises €0.02 to €0.04
QUEEN-KING-QQKK: folds 
caduceus369: folds 
Warterror90: folds 
CarlaBBruni: folds 
CIKO71131: calls €0.02
*** FLOP *** [Js 2h 2d]
CIKO71131: checks 
McSup: checks 
*** TURN *** [Js 2h 2d] [9s]
CIKO71131: checks 
McSup: checks 
*** RIVER *** [Js 2h 2d 9s] [Tc]
CIKO71131: checks 
McSup: checks 
*** SHOW DOWN ***
CIKO71131: shows [4h Qs] (a pair of Deuces)
McSup: shows [3h Ah] (a pair of Deuces - Ace kicker)
McSup collected €0.09 from pot
*** SUMMARY ***
Total pot €0.09 | Rake €0 
Board [Js 2h 2d 9s Tc]
Seat 1: Warterror90 (button) folded before Flop (didn't bet)
Seat 2: CarlaBBruni (small blind) folded before Flop
Seat 3: CIKO71131 (big blind) showed [4h Qs] and lost with a pair of Deuces
Seat 4: McSup showed [3h Ah] and won (€0.09) with a pair of Deuces
Seat 5: QUEEN-KING-QQKK folded before Flop (didn't bet)
Seat 6: caduceus369 folded before Flop (didn't bet)



PokerStars Zoom Hand #258129019110:  Hold'em No Limit (€0.01/€0.02) [ADM ID: M62C63044C87BABT] - 2025/10/15 0:54:19 CET [2025/10/14 18:54:19 ET]
Table 'Sirio' 6-max Seat #1 is the button
Seat 1: caduceus369 (€2 in chips) 
Seat 2: Warterror90 (€2.95 in chips) 
Seat 3: QUEEN-KING-QQKK (€1.77 in chips) 
Seat 4: McSup (€3.85 in chips) 
Seat 5: 2PaperelaSgubio (€2.06 in chips) 
Seat 6: Crock361 (€2.62 in chips) 
Warterror90: posts small blind €0.01
QUEEN-KING-QQKK: posts big blind €0.02
*** HOLE CARDS ***
Dealt to caduceus369 [Ah 7c]
McSup: calls €0.02
2PaperelaSgubio: folds 
Crock361: folds 
caduceus369: folds 
Warterror90: folds 
QUEEN-KING-QQKK: checks 
*** FLOP *** [6s 3c 7h]
QUEEN-KING-QQKK: bets €0.06
McSup: folds 
Uncalled bet (€0.06) returned to QUEEN-KING-QQKK
QUEEN-KING-QQKK collected €0.05 from pot
QUEEN-KING-QQKK: doesn't show hand 
*** SUMMARY ***
Total pot €0.05 | Rake €0 
Board [6s 3c 7h]
Seat 1: caduceus369 (button) folded before Flop (didn't bet)
Seat 2: Warterror90 (small blind) folded before Flop
Seat 3: QUEEN-KING-QQKK (big blind) collected (€0.05)
Seat 4: McSup folded on the Flop
Seat 5: 2PaperelaSgubio folded before Flop (didn't bet)
Seat 6: Crock361 folded before Flop (didn't bet)



PokerStars Zoom Hand #258129022450:  Hold'em No Limit (€0.01/€0.02) [ADM ID: M62C63044C87BABT] - 2025/10/15 0:54:37 CET [2025/10/14 18:54:37 ET]
Table 'Sirio' 6-max Seat #1 is the button
Seat 1: mashallahh (€2.82 in chips) 
Seat 2: EasyToRule (€2.03 in chips) 
Seat 3: gigiriver170 (€0.75 in chips) 
Seat 4: caduceus369 (€2 in chips) 
Seat 5: Trezvenik93 (€2.07 in chips) 
Seat 6: SebaRapy14 (€3.67 in chips) 
EasyToRule: posts small blind €0.01
gigiriver170: posts big blind €0.02
*** HOLE CARDS ***
Dealt to caduceus369 [3c Th]
caduceus369: folds 
Trezvenik93: folds 
SebaRapy14: folds 
mashallahh: raises €0.04 to €0.06
EasyToRule: folds 
gigiriver170: folds 
Uncalled bet (€0.04) returned to mashallahh
mashallahh collected €0.05 from pot
mashallahh: doesn't show hand 
*** SUMMARY ***
Total pot €0.05 | Rake €0 
Seat 1: mashallahh (button) collected (€0.05)
Seat 2: EasyToRule (small blind) folded before Flop
Seat 3: gigiriver170 (big blind) folded before Flop
Seat 4: caduceus369 folded before Flop (didn't bet)
Seat 5: Trezvenik93 folded before Flop (didn't bet)
Seat 6: SebaRapy14 folded before Flop (didn't bet)



PokerStars Zoom Hand #258129023019:  Hold'em No Limit (€0.01/€0.02) [ADM ID: M62C63044C87BABT] - 2025/10/15 0:54:40 CET [2025/10/14 18:54:40 ET]
Table 'Sirio' 6-max Seat #1 is the button
Seat 1: Rrrr322 (€2.46 in chips) 
Seat 2: CarlaBBruni (€1.89 in chips) 
Seat 3: caduceus369 (€2 in chips) 
Seat 4: father2008 (€2 in chips) 
Seat 5: Trezvenik93 (€2.07 in chips) 
Seat 6: mashallahh (€8.77 in chips) 
CarlaBBruni: posts small blind €0.01
caduceus369: posts big blind €0.02
*** HOLE CARDS ***
Dealt to caduceus369 [5s 2c]
father2008: folds 
Trezvenik93: folds 
mashallahh: folds 
Rrrr322: calls €0.02
CarlaBBruni: folds 
caduceus369: checks 
*** FLOP *** [Ac 8h Jd]
caduceus369: checks 
Rrrr322: checks 
*** TURN *** [Ac 8h Jd] [2h]
caduceus369: bets €0.02
Rrrr322: calls €0.02
*** RIVER *** [Ac 8h Jd 2h] [Qd]
caduceus369: checks 
Rrrr322: checks 
*** SHOW DOWN ***
caduceus369: shows [5s 2c] (a pair of Deuces)
Rrrr322: mucks hand 
caduceus369 collected €0.09 from pot
*** SUMMARY ***
Total pot €0.09 | Rake €0 
Board [Ac 8h Jd 2h Qd]
Seat 1: Rrrr322 (button) mucked [3d Ts]
Seat 2: CarlaBBruni (small blind) folded before Flop
Seat 3: caduceus369 (big blind) showed [5s 2c] and won (€0.09) with a pair of Deuces
Seat 4: father2008 folded before Flop (didn't bet)
Seat 5: Trezvenik93 folded before Flop (didn't bet)
Seat 6: mashallahh folded before Flop (didn't bet)



PokerStars Zoom Hand #258129029537:  Hold'em No Limit (€0.01/€0.02) [ADM ID: M62C63044C87BABT] - 2025/10/15 0:55:17 CET [2025/10/14 18:55:17 ET]
Table 'Sirio' 6-max Seat #1 is the button
Seat 1: Agnese84 (€0.68 in chips) 
Seat 2: caduceus369 (€2.05 in chips) 
Seat 3: Poetto65 (€1.04 in chips) 
Seat 4: EasyToRule (€2.13 in chips) 
Seat 5: Warterror90 (€3.07 in chips) 
Seat 6: Rrrr322 (€2.42 in chips) 
caduceus369: posts small blind €0.01
Poetto65: posts big blind €0.02
*** HOLE CARDS ***
Dealt to caduceus369 [9c Kh]
EasyToRule: raises €0.03 to €0.05
Warterror90: calls €0.05
Rrrr322: calls €0.05
Agnese84: calls €0.05
caduceus369: folds 
Poetto65: folds 
*** FLOP *** [5d 7h 7d]
EasyToRule: checks 
Warterror90: checks 
Rrrr322: checks 
Agnese84: checks 
*** TURN *** [5d 7h 7d] [4d]
EasyToRule: checks 
Warterror90: checks 
Rrrr322: bets €0.10
Agnese84: folds 
EasyToRule: folds 
Warterror90: folds 
Uncalled bet (€0.10) returned to Rrrr322
Rrrr322 collected €0.22 from pot
Rrrr322: doesn't show hand 
*** SUMMARY ***
Total pot €0.23 | Rake €0.01 
Board [5d 7h 7d 4d]
Seat 1: Agnese84 (button) folded on the Turn
Seat 2: caduceus369 (small blind) folded before Flop
Seat 3: Poetto65 (big blind) folded before Flop
Seat 4: EasyToRule folded on the Turn
Seat 5: Warterror90 folded on the Turn
Seat 6: Rrrr322 collected (€0.22)



PokerStars Zoom Hand #258129031570:  Hold'em No Limit (€0.01/€0.02) [ADM ID: M62C63044C87BABT] - 2025/10/15 0:55:31 CET [2025/10/14 18:55:31 ET]
Table 'Sirio' 6-max Seat #1 is the button
Seat 1: mashallahh (€5.98 in chips) 
Seat 2: TheMule1454 (€2.41 in chips) 
Seat 3: il_jack$$$58 (€2.83 in chips) 
Seat 4: CarlaBBruni (€1.83 in chips) 
Seat 5: caduceus369 (€2.04 in chips) 
Seat 6: bv0360 (€0.89 in chips) 
TheMule1454: posts small blind €0.01
il_jack$$$58: posts big blind €0.02
*** HOLE CARDS ***
Dealt to caduceus369 [Jc Qd]
CarlaBBruni: folds 
caduceus369: raises €0.04 to €0.06
bv0360: raises €0.04 to €0.10
mashallahh: folds 
TheMule1454: folds 
il_jack$$$58: folds 
caduceus369: calls €0.04
*** FLOP *** [2d 8h Td]
caduceus369: checks 
bv0360: bets €0.11
caduceus369: folds 
Uncalled bet (€0.11) returned to bv0360
bv0360 collected €0.22 from pot
bv0360: doesn't show hand 
*** SUMMARY ***
Total pot €0.23 | Rake €0.01 
Board [2d 8h Td]
Seat 1: mashallahh (button) folded before Flop (didn't bet)
Seat 2: TheMule1454 (small blind) folded before Flop
Seat 3: il_jack$$$58 (big blind) folded before Flop
Seat 4: CarlaBBruni folded before Flop (didn't bet)
Seat 5: caduceus369 folded on the Flop
Seat 6: bv0360 collected (€0.22)



PokerStars Zoom Hand #258129037718:  Hold'em No Limit (€0.01/€0.02) [ADM ID: M62C63044C87BABT] - 2025/10/15 0:56:13 CET [2025/10/14 18:56:13 ET]
Table 'Sirio' 6-max Seat #1 is the button
Seat 1: TheMule1454 (€3.29 in chips) 
Seat 2: mashallahh (€2.82 in chips) 
Seat 3: meteco79 (€1.14 in chips) 
Seat 4: caduceus369 (€2 in chips) 
Seat 5: Agnese84 (€0.61 in chips) 
Seat 6: Temait77728 (€2.85 in chips) 
mashallahh: posts small blind €0.01
meteco79: posts big blind €0.02
*** HOLE CARDS ***
Dealt to caduceus369 [8d 9s]
caduceus369: folds 
Agnese84: folds 
Temait77728: folds 
TheMule1454: folds 
mashallahh: folds 
Uncalled bet (€0.01) returned to meteco79
meteco79 collected €0.02 from pot
meteco79: doesn't show hand 
*** SUMMARY ***
Total pot €0.02 | Rake €0 
Seat 1: TheMule1454 (button) folded before Flop (didn't bet)
Seat 2: mashallahh (small blind) folded before Flop
Seat 3: meteco79 (big blind) collected (€0.02)
Seat 4: caduceus369 folded before Flop (didn't bet)
Seat 5: Agnese84 folded before Flop (didn't bet)
Seat 6: Temait77728 folded before Flop (didn't bet)



PokerStars Zoom Hand #258129038612:  Hold'em No Limit (€0.01/€0.02) [ADM ID: M62C63044C87BABT] - 2025/10/15 0:56:19 CET [2025/10/14 18:56:19 ET]
Table 'Sirio' 6-max Seat #1 is the button
Seat 1: mashallahh (€2.81 in chips) 
Seat 2: Trezvenik93 (€2 in chips) 
Seat 3: Warterror90 (€4.26 in chips) 
Seat 4: caduceus369 (€2 in chips) 
Seat 5: ADRIAN0_MEIS (€5.44 in chips) 
Seat 6: Agnese84 (€0.60 in chips) 
Trezvenik93: posts small blind €0.01
Warterror90: posts big blind €0.02
*** HOLE CARDS ***
Dealt to caduceus369 [Ts Kc]
caduceus369: folds 
ADRIAN0_MEIS: folds 
Agnese84: folds 
mashallahh: folds 
Trezvenik93: raises €0.03 to €0.05
Warterror90: folds 
Uncalled bet (€0.03) returned to Trezvenik93
Trezvenik93 collected €0.04 from pot
Trezvenik93: doesn't show hand 
*** SUMMARY ***
Total pot €0.04 | Rake €0 
Seat 1: mashallahh (button) folded before Flop (didn't bet)
Seat 2: Trezvenik93 (small blind) collected (€0.04)
Seat 3: Warterror90 (big blind) folded before Flop
Seat 4: caduceus369 folded before Flop (didn't bet)
Seat 5: ADRIAN0_MEIS folded before Flop (didn't bet)
Seat 6: Agnese84 folded before Flop (didn't bet)



PokerStars Zoom Hand #258129039892:  Hold'em No Limit (€0.01/€0.02) [ADM ID: M62C63044C87BABT] - 2025/10/15 0:56:28 CET [2025/10/14 18:56:28 ET]
Table 'Sirio' 6-max Seat #1 is the button
Seat 1: caduceus369 (€2 in chips) 
Seat 2: Warterror90 (€4.24 in chips) 
Seat 3: Agnese84 (€0.60 in chips) 
Seat 4: CarlaBBruni (€1.83 in chips) 
Seat 5: father2008 (€2.37 in chips) 
Seat 6: TheMule1454 (€3.29 in chips) 
Warterror90: posts small blind €0.01
Agnese84: posts big blind €0.02
*** HOLE CARDS ***
Dealt to caduceus369 [Ad Ah]
CarlaBBruni: folds 
father2008: folds 
TheMule1454: folds 
caduceus369: raises €0.04 to €0.06
Warterror90: folds 
Agnese84: calls €0.04
*** FLOP *** [Ks 6c 5c]
Agnese84: bets €0.54 and is all-in
caduceus369: calls €0.54
*** TURN *** [Ks 6c 5c] [5h]
*** RIVER *** [Ks 6c 5c 5h] [8s]
*** SHOW DOWN ***
Agnese84: shows [3s Kc] (two pair, Kings and Fives)
caduceus369: shows [Ad Ah] (two pair, Aces and Fives)
caduceus369 collected €1.15 from pot
*** SUMMARY ***
Total pot €1.21 | Rake €0.06 
Board [Ks 6c 5c 5h 8s]
Seat 1: caduceus369 (button) showed [Ad Ah] and won (€1.15) with two pair, Aces and Fives
Seat 2: Warterror90 (small blind) folded before Flop
Seat 3: Agnese84 (big blind) showed [3s Kc] and lost with two pair, Kings and Fives
Seat 4: CarlaBBruni folded before Flop (didn't bet)
Seat 5: father2008 folded before Flop (didn't bet)
Seat 6: TheMule1454 folded before Flop (didn't bet)



PokerStars Zoom Hand #258129039419:  Hold'em No Limit (€0.01/€0.02) [ADM ID: M62C63044C87BABT] - 2025/10/15 0:56:24 CET [2025/10/14 18:56:24 ET]
Table 'Sirio' 6-max Seat #1 is the button
Seat 1: Agnese84 (€0.60 in chips) 
Seat 2: mashallahh (€8.40 in chips) 
Seat 3: Freddy15081988 (€0.83 in chips) 
Seat 4: ADRIAN0_MEIS (€5.44 in chips) 
Seat 5: caduceus369 (€2 in chips) 
Seat 6: EasyToRule (€2.05 in chips) 
mashallahh: posts small blind €0.01
Freddy15081988: posts big blind €0.02
*** HOLE CARDS ***
Dealt to caduceus369 [2c 3h]
ADRIAN0_MEIS: raises €0.05 to €0.07
caduceus369: folds 
EasyToRule: folds 
Agnese84: folds 
mashallahh: folds 
Freddy15081988: calls €0.05
*** FLOP *** [9c 8h Kc]
Freddy15081988: checks 
ADRIAN0_MEIS: bets €0.08
Freddy15081988: raises €0.08 to €0.16
ADRIAN0_MEIS: calls €0.08
*** TURN *** [9c 8h Kc] [Ac]
Freddy15081988: bets €0.23
ADRIAN0_MEIS: raises €4.40 to €4.63
Freddy15081988: calls €0.37 and is all-in
Uncalled bet (€4.03) returned to ADRIAN0_MEIS
*** FIRST RIVER *** [9c 8h Kc Ac] [Td]
*** SECOND RIVER *** [9c 8h Kc Ac] [3c]
*** FIRST SHOW DOWN ***
Freddy15081988: shows [8s 9s] (two pair, Nines and Eights)
ADRIAN0_MEIS: shows [Ad Qc] (a pair of Aces)
Freddy15081988 collected €0.79 from pot
*** SECOND SHOW DOWN ***
Freddy15081988: shows [8s 9s] (two pair, Nines and Eights)
ADRIAN0_MEIS: shows [Ad Qc] (a flush, Ace high)
ADRIAN0_MEIS collected €0.79 from pot
*** SUMMARY ***
Total pot €1.67 | Rake €0.09 
Hand was run twice
FIRST Board [9c 8h Kc Ac Td]
SECOND Board [9c 8h Kc Ac 3c]
Seat 1: Agnese84 (button) folded before Flop (didn't bet)
Seat 2: mashallahh (small blind) folded before Flop
Seat 3: Freddy15081988 (big blind) showed [8s 9s] and won (€0.79) with two pair, Nines and Eights, and lost with two pair, Nines and Eights
Seat 4: ADRIAN0_MEIS showed [Ad Qc] and lost with a pair of Aces, and won (€0.79) with a flush, Ace high
Seat 5: caduceus369 folded before Flop (didn't bet)
Seat 6: EasyToRule folded before Flop (didn't bet)



PokerStars Zoom Hand #258129047123:  Hold'em No Limit (€0.01/€0.02) [ADM ID: M62C63044C87BABT] - 2025/10/15 0:57:18 CET [2025/10/14 18:57:18 ET]
Table 'Sirio' 6-max Seat #1 is the button
Seat 1: Warterror90 (€3.17 in chips) 
Seat 2: caduceus369 (€2.53 in chips) 
Seat 3: EasyToRule (€2.18 in chips) 
Seat 4: QUEEN-KING-QQKK (€3.34 in chips) 
Seat 5: TheMule1454 (€3.15 in chips) 
Seat 6: Poetto65 (€0.98 in chips) 
caduceus369: posts small blind €0.01
EasyToRule: posts big blind €0.02
*** HOLE CARDS ***
Dealt to caduceus369 [2s Ac]
QUEEN-KING-QQKK: folds 
TheMule1454: folds 
Poetto65: folds 
Warterror90: raises €0.04 to €0.06
caduceus369: folds 
EasyToRule: folds 
Uncalled bet (€0.04) returned to Warterror90
Warterror90 collected €0.05 from pot
Warterror90: doesn't show hand 
*** SUMMARY ***
Total pot €0.05 | Rake €0 
Seat 1: Warterror90 (button) collected (€0.05)
Seat 2: caduceus369 (small blind) folded before Flop
Seat 3: EasyToRule (big blind) folded before Flop
Seat 4: QUEEN-KING-QQKK folded before Flop (didn't bet)
Seat 5: TheMule1454 folded before Flop (didn't bet)
Seat 6: Poetto65 folded before Flop (didn't bet)



PokerStars Zoom Hand #258129045378:  Hold'em No Limit (€0.01/€0.02) [ADM ID: M62C63044C87BABT] - 2025/10/15 0:57:06 CET [2025/10/14 18:57:06 ET]
Table 'Sirio' 6-max Seat #1 is the button
Seat 1: McSup (€1.88 in chips) 
Seat 2: SebaRapy14 (€3.94 in chips) 
Seat 3: caduceus369 (€2.55 in chips) 
Seat 4: il_jack$$$58 (€2.37 in chips) 
Seat 5: CarlaBBruni (€1.77 in chips) 
Seat 6: QUEEN-KING-QQKK (€1.30 in chips) 
SebaRapy14: posts small blind €0.01
caduceus369: posts big blind €0.02
*** HOLE CARDS ***
Dealt to caduceus369 [4h 3d]
il_jack$$$58: folds 
CarlaBBruni: raises €0.02 to €0.04
QUEEN-KING-QQKK: calls €0.04
McSup: folds 
SebaRapy14: calls €0.03
caduceus369: folds 
*** FLOP *** [9d As 8s]
SebaRapy14: checks 
CarlaBBruni: checks 
QUEEN-KING-QQKK: checks 
*** TURN *** [9d As 8s] [7c]
SebaRapy14: bets €0.08
CarlaBBruni: raises €0.10 to €0.18
QUEEN-KING-QQKK: calls €0.18
SebaRapy14: calls €0.10
*** RIVER *** [9d As 8s 7c] [3s]
SebaRapy14: checks 
CarlaBBruni: checks 
QUEEN-KING-QQKK: checks 
*** SHOW DOWN ***
SebaRapy14: shows [Ks Ah] (a pair of Aces)
CarlaBBruni: shows [7d 7h] (three of a kind, Sevens)
QUEEN-KING-QQKK: mucks hand 
CarlaBBruni collected €0.65 from pot
*** SUMMARY ***
Total pot €0.68 | Rake €0.03 
Board [9d As 8s 7c 3s]
Seat 1: McSup (button) folded before Flop (didn't bet)
Seat 2: SebaRapy14 (small blind) showed [Ks Ah] and lost with a pair of Aces
Seat 3: caduceus369 (big blind) folded before Flop
Seat 4: il_jack$$$58 folded before Flop (didn't bet)
Seat 5: CarlaBBruni showed [7d 7h] and won (€0.65) with three of a kind, Sevens
Seat 6: QUEEN-KING-QQKK mucked [7s 6h]



PokerStars Zoom Hand #258129049174:  Hold'em No Limit (€0.01/€0.02) [ADM ID: M62C63044C87BABT] - 2025/10/15 0:57:32 CET [2025/10/14 18:57:32 ET]
Table 'Sirio' 6-max Seat #1 is the button
Seat 1: Trezvenik93 (€2.50 in chips) 
Seat 2: QUEEN-KING-QQKK (€3.34 in chips) 
Seat 3: Plutonia72 (€1.66 in chips) 
Seat 4: TheMule1454 (€3.14 in chips) 
Seat 5: uziu47 (€0.91 in chips) 
Seat 6: caduceus369 (€2.52 in chips) 
QUEEN-KING-QQKK: posts small blind €0.01
Plutonia72: posts big blind €0.02
*** HOLE CARDS ***
Dealt to caduceus369 [Kh 6s]
TheMule1454: folds 
uziu47: folds 
caduceus369: folds 
Trezvenik93: folds 
QUEEN-KING-QQKK: calls €0.01
Plutonia72: raises €0.04 to €0.06
QUEEN-KING-QQKK: calls €0.04
*** FLOP *** [8h 6c Tc]
QUEEN-KING-QQKK: checks 
Plutonia72: bets €0.06
QUEEN-KING-QQKK: folds 
Uncalled bet (€0.06) returned to Plutonia72
Plutonia72 collected €0.12 from pot
Plutonia72: doesn't show hand 
Plutonia72 is disconnected 
*** SUMMARY ***
Total pot €0.12 | Rake €0 
Board [8h 6c Tc]
Seat 1: Trezvenik93 (button) folded before Flop (didn't bet)
Seat 2: QUEEN-KING-QQKK (small blind) folded on the Flop
Seat 3: Plutonia72 (big blind) collected (€0.12)
Seat 4: TheMule1454 folded before Flop (didn't bet)
Seat 5: uziu47 folded before Flop (didn't bet)
Seat 6: caduceus369 folded before Flop (didn't bet)



PokerStars Zoom Hand #258129050855:  Hold'em No Limit (€0.01/€0.02) [ADM ID: M62C63044C87BABT] - 2025/10/15 0:57:44 CET [2025/10/14 18:57:44 ET]
Table 'Sirio' 6-max Seat #1 is the button
Seat 1: caduceus369 (€2.52 in chips) 
Seat 2: ADRIAN0_MEIS (€5.40 in chips) 
Seat 3: Temait77728 (€3.18 in chips) 
Seat 4: uziu47 (€0.91 in chips) 
Seat 5: mashallahh (€2.73 in chips) 
Seat 6: CIKO71131 (€1.38 in chips) 
ADRIAN0_MEIS: posts small blind €0.01
Temait77728: posts big blind €0.02
*** HOLE CARDS ***
Dealt to caduceus369 [5c 8s]
uziu47: folds 
mashallahh: folds 
CIKO71131: folds 
caduceus369: folds 
ADRIAN0_MEIS: folds 
Uncalled bet (€0.01) returned to Temait77728
Temait77728 collected €0.02 from pot
Temait77728: doesn't show hand 
*** SUMMARY ***
Total pot €0.02 | Rake €0 
Seat 1: caduceus369 (button) folded before Flop (didn't bet)
Seat 2: ADRIAN0_MEIS (small blind) folded before Flop
Seat 3: Temait77728 (big blind) collected (€0.02)
Seat 4: uziu47 folded before Flop (didn't bet)
Seat 5: mashallahh folded before Flop (didn't bet)
Seat 6: CIKO71131 folded before Flop (didn't bet)



PokerStars Zoom Hand #258129053454:  Hold'em No Limit (€0.01/€0.02) [ADM ID: M62C63044C87BABT] - 2025/10/15 0:58:02 CET [2025/10/14 18:58:02 ET]
Table 'Sirio' 6-max Seat #1 is the button
Seat 1: EasyToRule (€2.03 in chips) 
Seat 2: Warterror90 (€3.20 in chips) 
Seat 3: mashallahh (€8.75 in chips) 
Seat 4: il_jack$$$58 (€2.42 in chips) 
Seat 5: QUEEN-KING-QQKK (€1.11 in chips) 
Seat 6: caduceus369 (€2.52 in chips) 
Warterror90: posts small blind €0.01
mashallahh: posts big blind €0.02
*** HOLE CARDS ***
Dealt to caduceus369 [Kd 8d]
il_jack$$$58: folds 
QUEEN-KING-QQKK: folds 
caduceus369: raises €0.04 to €0.06
EasyToRule: folds 
Warterror90: folds 
mashallahh: folds 
Uncalled bet (€0.04) returned to caduceus369
caduceus369 collected €0.05 from pot
caduceus369: doesn't show hand 
*** SUMMARY ***
Total pot €0.05 | Rake €0 
Seat 1: EasyToRule (button) folded before Flop (didn't bet)
Seat 2: Warterror90 (small blind) folded before Flop
Seat 3: mashallahh (big blind) folded before Flop
Seat 4: il_jack$$$58 folded before Flop (didn't bet)
Seat 5: QUEEN-KING-QQKK folded before Flop (didn't bet)
Seat 6: caduceus369 collected (€0.05)



PokerStars Zoom Hand #258129055027:  Hold'em No Limit (€0.01/€0.02) [ADM ID: M62C63044C87BABT] - 2025/10/15 0:58:13 CET [2025/10/14 18:58:13 ET]
Table 'Sirio' 6-max Seat #1 is the button
Seat 1: McSup (€3.76 in chips) 
Seat 2: miridersa (€0.73 in chips) 
Seat 3: QUEEN-KING-QQKK (€1.11 in chips) 
Seat 4: mashallahh (€2.72 in chips) 
Seat 5: caduceus369 (€2.55 in chips) 
Seat 6: Temait77728 (€3.18 in chips) 
miridersa: posts small blind €0.01
QUEEN-KING-QQKK: posts big blind €0.02
*** HOLE CARDS ***
Dealt to caduceus369 [9d 5h]
mashallahh: folds 
caduceus369: folds 
Temait77728: raises €0.04 to €0.06
McSup: folds 
miridersa: folds 
QUEEN-KING-QQKK: calls €0.04
*** FLOP *** [8h Qd Ah]
QUEEN-KING-QQKK: checks 
Temait77728: checks 
*** TURN *** [8h Qd Ah] [Jc]
QUEEN-KING-QQKK: checks 
Temait77728: checks 
*** RIVER *** [8h Qd Ah Jc] [4c]
QUEEN-KING-QQKK: checks 
Temait77728: checks 
*** SHOW DOWN ***
QUEEN-KING-QQKK: shows [Qc 3c] (a pair of Queens)
Temait77728: mucks hand 
QUEEN-KING-QQKK collected €0.13 from pot
*** SUMMARY ***
Total pot €0.13 | Rake €0 
Board [8h Qd Ah Jc 4c]
Seat 1: McSup (button) folded before Flop (didn't bet)
Seat 2: miridersa (small blind) folded before Flop
Seat 3: QUEEN-KING-QQKK (big blind) showed [Qc 3c] and won (€0.13) with a pair of Queens
Seat 4: mashallahh folded before Flop (didn't bet)
Seat 5: caduceus369 folded before Flop (didn't bet)
Seat 6: Temait77728 mucked [Ks 7s]



PokerStars Zoom Hand #258129055877:  Hold'em No Limit (€0.01/€0.02) [ADM ID: M62C63044C87BABT] - 2025/10/15 0:58:19 CET [2025/10/14 18:58:19 ET]
Table 'Sirio' 6-max Seat #1 is the button
Seat 1: Begimon (€11.71 in chips) 
Seat 2: Warterror90 (€7.39 in chips) 
Seat 3: caduceus369 (€2.55 in chips) 
Seat 4: CarlaBBruni (€2.18 in chips) 
Seat 5: miridersa (€0.72 in chips) 
Seat 6: mashallahh (€2.72 in chips) 
Warterror90: posts small blind €0.01
caduceus369: posts big blind €0.02
*** HOLE CARDS ***
Dealt to caduceus369 [3c 7h]
CarlaBBruni: folds 
miridersa: folds 
mashallahh: folds 
Begimon: calls €0.02
Warterror90: folds 
caduceus369: checks 
*** FLOP *** [Jh Ah 3h]
caduceus369: bets €0.02
Begimon: calls €0.02
*** TURN *** [Jh Ah 3h] [Td]
caduceus369: checks 
Begimon: checks 
*** RIVER *** [Jh Ah 3h Td] [Qc]
caduceus369: checks 
Begimon: bets €0.14
caduceus369: folds 
Uncalled bet (€0.14) returned to Begimon
Begimon collected €0.09 from pot
Begimon: doesn't show hand 
*** SUMMARY ***
Total pot €0.09 | Rake €0 
Board [Jh Ah 3h Td Qc]
Seat 1: Begimon (button) collected (€0.09)
Seat 2: Warterror90 (small blind) folded before Flop
Seat 3: caduceus369 (big blind) folded on the River
Seat 4: CarlaBBruni folded before Flop (didn't bet)
Seat 5: miridersa folded before Flop (didn't bet)
Seat 6: mashallahh folded before Flop (didn't bet)



PokerStars Zoom Hand #258129061625:  Hold'em No Limit (€0.01/€0.02) [ADM ID: M62C63044C87BABT] - 2025/10/15 0:59:00 CET [2025/10/14 18:59:00 ET]
Table 'Sirio' 6-max Seat #1 is the button
Seat 1: Trezvenik93 (€2.89 in chips) 
Seat 2: caduceus369 (€2.51 in chips) 
Seat 3: Temait77728 (€3.11 in chips) 
Seat 4: mashallahh (€8.73 in chips) 
Seat 5: il_jack$$$58 (€2.37 in chips) 
Seat 6: Plutonia72 (€1.63 in chips) 
caduceus369: posts small blind €0.01
Temait77728: posts big blind €0.02
*** HOLE CARDS ***
Dealt to caduceus369 [Tc 9d]
mashallahh: folds 
il_jack$$$58: folds 
Plutonia72: folds 
Trezvenik93: folds 
caduceus369: folds 
Uncalled bet (€0.01) returned to Temait77728
Temait77728 collected €0.02 from pot
Temait77728: doesn't show hand 
*** SUMMARY ***
Total pot €0.02 | Rake €0 
Seat 1: Trezvenik93 (button) folded before Flop (didn't bet)
Seat 2: caduceus369 (small blind) folded before Flop
Seat 3: Temait77728 (big blind) collected (€0.02)
Seat 4: mashallahh folded before Flop (didn't bet)
Seat 5: il_jack$$$58 folded before Flop (didn't bet)
Seat 6: Plutonia72 folded before Flop (didn't bet)



PokerStars Zoom Hand #258129063233:  Hold'em No Limit (€0.01/€0.02) [ADM ID: M62C63044C87BABT] - 2025/10/15 0:59:11 CET [2025/10/14 18:59:11 ET]
Table 'Sirio' 6-max Seat #1 is the button
Seat 1: caduceus369 (€2.50 in chips) 
Seat 2: mashallahh (€2.70 in chips) 
Seat 3: Begimon (€11.76 in chips) 
Seat 4: EasyToRule (€2.02 in chips) 
Seat 5: Plutonia72 (€1.63 in chips) 
Seat 6: SebaRapy14 (€3.84 in chips) 
mashallahh: posts small blind €0.01
Begimon: posts big blind €0.02
*** HOLE CARDS ***
Dealt to caduceus369 [5s 2c]
EasyToRule: folds 
Plutonia72: folds 
SebaRapy14: folds 
caduceus369: folds 
mashallahh: folds 
Uncalled bet (€0.01) returned to Begimon
Begimon collected €0.02 from pot
Begimon: doesn't show hand 
*** SUMMARY ***
Total pot €0.02 | Rake €0 
Seat 1: caduceus369 (button) folded before Flop (didn't bet)
Seat 2: mashallahh (small blind) folded before Flop
Seat 3: Begimon (big blind) collected (€0.02)
Seat 4: EasyToRule folded before Flop (didn't bet)
Seat 5: Plutonia72 folded before Flop (didn't bet)
Seat 6: SebaRapy14 folded before Flop (didn't bet)



PokerStars Zoom Hand #258129055458:  Hold'em No Limit (€0.01/€0.02) [ADM ID: M62C63044C87BABT] - 2025/10/15 0:58:16 CET [2025/10/14 18:58:16 ET]
Table 'Sirio' 6-max Seat #1 is the button
Seat 1: QUEEN-KING-QQKK (€3.26 in chips) 
Seat 2: mashallahh (€8.30 in chips) 
Seat 3: Plutonia72 (€1.70 in chips) 
Seat 4: caduceus369 (€2.55 in chips) 
Seat 5: ADRIAN0_MEIS (€5.40 in chips) 
Seat 6: Warterror90 (€3.17 in chips) 
mashallahh: posts small blind €0.01
Plutonia72: posts big blind €0.02
*** HOLE CARDS ***
Dealt to caduceus369 [6h Qd]
caduceus369: folds 
ADRIAN0_MEIS: raises €0.04 to €0.06
Warterror90: calls €0.06
QUEEN-KING-QQKK: folds 
mashallahh: folds 
Plutonia72: calls €0.04
*** FLOP *** [Js Jc 6c]
Plutonia72: checks 
ADRIAN0_MEIS: bets €0.10
Warterror90: raises €0.14 to €0.24
Plutonia72: folds 
ADRIAN0_MEIS: calls €0.14
*** TURN *** [Js Jc 6c] [2s]
ADRIAN0_MEIS: checks 
Warterror90: bets €0.26
ADRIAN0_MEIS: calls €0.26
*** RIVER *** [Js Jc 6c 2s] [2c]
ADRIAN0_MEIS: checks 
Warterror90: checks 
*** SHOW DOWN ***
ADRIAN0_MEIS: shows [5h 5d] (two pair, Jacks and Fives)
Warterror90: shows [Td Tc] (two pair, Jacks and Tens)
Warterror90 collected €1.13 from pot
*** SUMMARY ***
Total pot €1.19 | Rake €0.06 
Board [Js Jc 6c 2s 2c]
Seat 1: QUEEN-KING-QQKK (button) folded before Flop (didn't bet)
Seat 2: mashallahh (small blind) folded before Flop
Seat 3: Plutonia72 (big blind) folded on the Flop
Seat 4: caduceus369 folded before Flop (didn't bet)
Seat 5: ADRIAN0_MEIS showed [5h 5d] and lost with two pair, Jacks and Fives
Seat 6: Warterror90 showed [Td Tc] and won (€1.13) with two pair, Jacks and Tens



PokerStars Zoom Hand #258129063669:  Hold'em No Limit (€0.01/€0.02) [ADM ID: M62C63044C87BABT] - 2025/10/15 0:59:14 CET [2025/10/14 18:59:14 ET]
Table 'Sirio' 6-max Seat #1 is the button
Seat 1: Temait77728 (€3.12 in chips) 
Seat 2: QUEEN-KING-QQKK (€3.05 in chips) 
Seat 3: franck19621962 (€0.43 in chips) 
Seat 4: caduceus369 (€2.50 in chips) 
Seat 5: Trezvenik93 (€2.88 in chips) 
Seat 6: mashallahh (€8.73 in chips) 
QUEEN-KING-QQKK: posts small blind €0.01
franck19621962: posts big blind €0.02
*** HOLE CARDS ***
Dealt to caduceus369 [Jd Jc]
caduceus369: raises €0.04 to €0.06
Trezvenik93: folds 
mashallahh: raises €0.12 to €0.18
Temait77728: folds 
QUEEN-KING-QQKK: folds 
franck19621962: folds 
caduceus369: raises €0.36 to €0.54
mashallahh: folds 
Uncalled bet (€0.36) returned to caduceus369
caduceus369 collected €0.39 from pot
caduceus369: doesn't show hand 
*** SUMMARY ***
Total pot €0.39 | Rake €0 
Seat 1: Temait77728 (button) folded before Flop (didn't bet)
Seat 2: QUEEN-KING-QQKK (small blind) folded before Flop
Seat 3: franck19621962 (big blind) folded before Flop
Seat 4: caduceus369 collected (€0.39)
Seat 5: Trezvenik93 folded before Flop (didn't bet)
Seat 6: mashallahh folded before Flop



PokerStars Zoom Hand #258129067532:  Hold'em No Limit (€0.01/€0.02) [ADM ID: M62C63044C87BABT] - 2025/10/15 0:59:41 CET [2025/10/14 18:59:41 ET]
Table 'Sirio' 6-max Seat #1 is the button
Seat 1: father2008 (€2 in chips) 
Seat 2: meteco79 (€1.41 in chips) 
Seat 3: mashallahh (€2.69 in chips) 
Seat 4: QUEEN-KING-QQKK (€1.87 in chips) 
Seat 5: Temait77728 (€3.11 in chips) 
Seat 6: caduceus369 (€2.71 in chips) 
meteco79: posts small blind €0.01
mashallahh: posts big blind €0.02
*** HOLE CARDS ***
Dealt to caduceus369 [4c Ac]
QUEEN-KING-QQKK: raises €0.05 to €0.07
Temait77728: calls €0.07
caduceus369: calls €0.07
father2008: folds 
meteco79: folds 
mashallahh: folds 
*** FLOP *** [3d 6h Qc]
QUEEN-KING-QQKK: checks 
Temait77728: checks 
caduceus369: checks 
*** TURN *** [3d 6h Qc] [4d]
QUEEN-KING-QQKK: checks 
Temait77728: checks 
caduceus369: bets €0.04
QUEEN-KING-QQKK: calls €0.04
Temait77728: folds 
*** RIVER *** [3d 6h Qc 4d] [2s]
QUEEN-KING-QQKK: checks 
caduceus369: checks 
*** SHOW DOWN ***
QUEEN-KING-QQKK: shows [Td Kd] (high card King)
caduceus369: shows [4c Ac] (a pair of Fours)
caduceus369 collected €0.31 from pot
*** SUMMARY ***
Total pot €0.32 | Rake €0.01 
Board [3d 6h Qc 4d 2s]
Seat 1: father2008 (button) folded before Flop (didn't bet)
Seat 2: meteco79 (small blind) folded before Flop
Seat 3: mashallahh (big blind) folded before Flop
Seat 4: QUEEN-KING-QQKK showed [Td Kd] and lost with high card King
Seat 5: Temait77728 folded on the Turn
Seat 6: caduceus369 showed [4c Ac] and won (€0.31) with a pair of Fours



PokerStars Zoom Hand #258129077110:  Hold'em No Limit (€0.01/€0.02) [ADM ID: M62C63044C87BABT] - 2025/10/15 1:00:45 CET [2025/10/14 19:00:45 ET]
Table 'Sirio' 6-max Seat #1 is the button
Seat 1: father2008 (€2.42 in chips) 
Seat 2: miridersa (€0.64 in chips) 
Seat 3: caduceus369 (€2.91 in chips) 
Seat 4: mashallahh (€8.52 in chips) 
Seat 5: QUEEN-KING-QQKK (€1.76 in chips) 
miridersa: posts small blind €0.01
caduceus369: posts big blind €0.02
*** HOLE CARDS ***
Dealt to caduceus369 [4c 2c]
mashallahh: folds 
QUEEN-KING-QQKK: folds 
father2008: folds 
miridersa: folds 
Uncalled bet (€0.01) returned to caduceus369
caduceus369 collected €0.02 from pot
caduceus369: doesn't show hand 
*** SUMMARY ***
Total pot €0.02 | Rake €0 
Seat 1: father2008 (button) folded before Flop (didn't bet)
Seat 2: miridersa (small blind) folded before Flop
Seat 3: caduceus369 (big blind) collected (€0.02)
Seat 4: mashallahh folded before Flop (didn't bet)
Seat 5: QUEEN-KING-QQKK folded before Flop (didn't bet)



PokerStars Zoom Hand #258129079697:  Hold'em No Limit (€0.01/€0.02) [ADM ID: M62C63044C87BABT] - 2025/10/15 1:01:00 CET [2025/10/14 19:01:00 ET]
Table 'Sirio' 6-max Seat #1 is the button
Seat 1: mashallahh (€8.08 in chips) 
Seat 2: caduceus369 (€2.92 in chips) 
Seat 3: father2008 (€2.42 in chips) 
Seat 4: franck19621962 (€0.70 in chips) 
Seat 5: Trezvenik93 (€3.04 in chips) 
Seat 6: Warterror90 (€7.08 in chips) 
caduceus369: posts small blind €0.01
father2008: posts big blind €0.02
*** HOLE CARDS ***
Dealt to caduceus369 [8h Kd]
franck19621962: folds 
Trezvenik93: folds 
Warterror90: folds 
mashallahh: folds 
caduceus369: folds 
Uncalled bet (€0.01) returned to father2008
father2008 collected €0.02 from pot
father2008: doesn't show hand 
*** SUMMARY ***
Total pot €0.02 | Rake €0 
Seat 1: mashallahh (button) folded before Flop (didn't bet)
Seat 2: caduceus369 (small blind) folded before Flop
Seat 3: father2008 (big blind) collected (€0.02)
Seat 4: franck19621962 folded before Flop (didn't bet)
Seat 5: Trezvenik93 folded before Flop (didn't bet)
Seat 6: Warterror90 folded before Flop (didn't bet)



PokerStars Zoom Hand #258129081688:  Hold'em No Limit (€0.01/€0.02) [ADM ID: M62C63044C87BABT] - 2025/10/15 1:01:11 CET [2025/10/14 19:01:11 ET]
Table 'Sirio' 6-max Seat #1 is the button
Seat 1: caduceus369 (€2.91 in chips) 
Seat 2: father2008 (€2.43 in chips) 
Seat 3: il_jack$$$58 (€2.84 in chips) 
Seat 4: Trezvenik93 (€3.03 in chips) 
Seat 5: Temait77728 (€2.89 in chips) 
Seat 6: mashallahh (€2.92 in chips) 
father2008: posts small blind €0.01
il_jack$$$58: posts big blind €0.02
*** HOLE CARDS ***
Dealt to caduceus369 [4c 5d]
Trezvenik93: folds 
Temait77728: folds 
mashallahh: folds 
caduceus369: folds 
father2008: raises €0.04 to €0.06
il_jack$$$58: calls €0.04
*** FLOP *** [4h Kd 2h]
father2008: checks 
il_jack$$$58: bets €0.08
father2008: folds 
Uncalled bet (€0.08) returned to il_jack$$$58
il_jack$$$58 collected €0.12 from pot
il_jack$$$58: doesn't show hand 
*** SUMMARY ***
Total pot €0.12 | Rake €0 
Board [4h Kd 2h]
Seat 1: caduceus369 (button) folded before Flop (didn't bet)
Seat 2: father2008 (small blind) folded on the Flop
Seat 3: il_jack$$$58 (big blind) collected (€0.12)
Seat 4: Trezvenik93 folded before Flop (didn't bet)
Seat 5: Temait77728 folded before Flop (didn't bet)
Seat 6: mashallahh folded before Flop (didn't bet)



PokerStars Zoom Hand #258129080926:  Hold'em No Limit (€0.01/€0.02) [ADM ID: M62C63044C87BABT] - 2025/10/15 1:01:07 CET [2025/10/14 19:01:07 ET]
Table 'Sirio' 6-max Seat #1 is the button
Seat 1: Warterror90 (€6.81 in chips) 
Seat 2: EasyToRule (€2 in chips) 
Seat 3: mashallahh (€5.47 in chips) 
Seat 4: Plutonia72 (€2.03 in chips) 
Seat 5: caduceus369 (€2.91 in chips) 
EasyToRule: posts small blind €0.01
mashallahh: posts big blind €0.02
*** HOLE CARDS ***
Dealt to caduceus369 [3s 2s]
Plutonia72: raises €0.04 to €0.06
caduceus369: folds 
Warterror90: calls €0.06
EasyToRule: folds 
mashallahh: folds 
*** FLOP *** [As 2d Ts]
Plutonia72: bets €0.05
Warterror90: raises €0.09 to €0.14
Plutonia72: calls €0.09
*** TURN *** [As 2d Ts] [Qs]
Plutonia72: checks 
Warterror90: checks 
*** RIVER *** [As 2d Ts Qs] [9s]
Plutonia72: bets €0.49
Warterror90: folds 
Uncalled bet (€0.49) returned to Plutonia72
Plutonia72 collected €0.41 from pot
Plutonia72: doesn't show hand 
*** SUMMARY ***
Total pot €0.43 | Rake €0.02 
Board [As 2d Ts Qs 9s]
Seat 1: Warterror90 (button) folded on the River
Seat 2: EasyToRule (small blind) folded before Flop
Seat 3: mashallahh (big blind) folded before Flop
Seat 4: Plutonia72 collected (€0.41)
Seat 5: caduceus369 folded before Flop (didn't bet)



PokerStars Zoom Hand #258129082513:  Hold'em No Limit (€0.01/€0.02) [ADM ID: M62C63044C87BABT] - 2025/10/15 1:01:16 CET [2025/10/14 19:01:16 ET]
Table 'Sirio' 6-max Seat #1 is the button
Seat 1: EasyToRule (€2 in chips) 
Seat 2: ilteatro131 (€2.29 in chips) 
Seat 3: bv0360 (€1.40 in chips) 
Seat 4: Warterror90 (€7.08 in chips) 
Seat 5: mashallahh (€5.45 in chips) 
Seat 6: caduceus369 (€2.91 in chips) 
ilteatro131: posts small blind €0.01
bv0360: posts big blind €0.02
*** HOLE CARDS ***
Dealt to caduceus369 [3c Ac]
Warterror90: folds 
mashallahh: folds 
caduceus369: raises €0.04 to €0.06
EasyToRule: folds 
ilteatro131: folds 
bv0360: calls €0.04
*** FLOP *** [7c 7s 6c]
bv0360: checks 
caduceus369: bets €0.04
bv0360: calls €0.04
*** TURN *** [7c 7s 6c] [Qd]
bv0360: checks 
caduceus369: checks 
*** RIVER *** [7c 7s 6c Qd] [Js]
bv0360: checks 
caduceus369: checks 
*** SHOW DOWN ***
bv0360: shows [8h 4h] (a pair of Sevens)
caduceus369: shows [3c Ac] (a pair of Sevens - Ace kicker)
caduceus369 collected €0.20 from pot
*** SUMMARY ***
Total pot €0.21 | Rake €0.01 
Board [7c 7s 6c Qd Js]
Seat 1: EasyToRule (button) folded before Flop (didn't bet)
Seat 2: ilteatro131 (small blind) folded before Flop
Seat 3: bv0360 (big blind) showed [8h 4h] and lost with a pair of Sevens
Seat 4: Warterror90 folded before Flop (didn't bet)
Seat 5: mashallahh folded before Flop (didn't bet)
Seat 6: caduceus369 showed [3c Ac] and won (€0.20) with a pair of Sevens



PokerStars Zoom Hand #258129095244:  Hold'em No Limit (€0.01/€0.02) [ADM ID: M62C63044C87BABT] - 2025/10/15 1:02:28 CET [2025/10/14 19:02:28 ET]
Table 'Sirio' 6-max Seat #1 is the button
Seat 1: QUEEN-KING-QQKK (€1.68 in chips) 
Seat 2: caduceus369 (€2.99 in chips) 
Seat 3: dandoshats (€1.97 in chips) 
Seat 4: mashallahh (€2.95 in chips) 
Seat 5: Trezvenik93 (€2.94 in chips) 
Seat 6: EasyToRule (€2 in chips) 
caduceus369: posts small blind €0.01
dandoshats: posts big blind €0.02
*** HOLE CARDS ***
Dealt to caduceus369 [2c 4h]
mashallahh: raises €0.04 to €0.06
Trezvenik93: folds 
EasyToRule: folds 
QUEEN-KING-QQKK: folds 
caduceus369: folds 
dandoshats: calls €0.04
*** FLOP *** [Tc 9c 2d]
dandoshats: checks 
mashallahh: bets €0.09
dandoshats: folds 
Uncalled bet (€0.09) returned to mashallahh
mashallahh collected €0.13 from pot
mashallahh: doesn't show hand 
*** SUMMARY ***
Total pot €0.13 | Rake €0 
Board [Tc 9c 2d]
Seat 1: QUEEN-KING-QQKK (button) folded before Flop (didn't bet)
Seat 2: caduceus369 (small blind) folded before Flop
Seat 3: dandoshats (big blind) folded on the Flop
Seat 4: mashallahh collected (€0.13)
Seat 5: Trezvenik93 folded before Flop (didn't bet)
Seat 6: EasyToRule folded before Flop (didn't bet)



PokerStars Zoom Hand #258129090025:  Hold'em No Limit (€0.01/€0.02) [ADM ID: M62C63044C87BABT] - 2025/10/15 1:01:58 CET [2025/10/14 19:01:58 ET]
Table 'Sirio' 6-max Seat #1 is the button
Seat 1: father2008 (€2.37 in chips) 
Seat 2: SebaRapy14 (€3.27 in chips) 
Seat 3: caduceus369 (€3.01 in chips) 
Seat 4: Poetto65 (€0.78 in chips) 
Seat 5: Temait77728 (€2.91 in chips) 
SebaRapy14: posts small blind €0.01
caduceus369: posts big blind €0.02
*** HOLE CARDS ***
Dealt to caduceus369 [7d 4c]
Poetto65 has timed out
Poetto65: folds 
Temait77728: raises €0.05 to €0.07
father2008: folds 
SebaRapy14: raises €0.21 to €0.28
caduceus369: folds 
Temait77728: calls €0.21
*** FLOP *** [6d 8s 2h]
SebaRapy14: bets €0.22
Temait77728: calls €0.22
*** TURN *** [6d 8s 2h] [5h]
SebaRapy14: bets €0.44
Temait77728: folds 
Uncalled bet (€0.44) returned to SebaRapy14
SebaRapy14 collected €0.97 from pot
SebaRapy14: doesn't show hand 
*** SUMMARY ***
Total pot €1.02 | Rake €0.05 
Board [6d 8s 2h 5h]
Seat 1: father2008 (button) folded before Flop (didn't bet)
Seat 2: SebaRapy14 (small blind) collected (€0.97)
Seat 3: caduceus369 (big blind) folded before Flop
Seat 4: Poetto65 folded before Flop (didn't bet)
Seat 5: Temait77728 folded on the Turn



PokerStars Zoom Hand #258129088798:  Hold'em No Limit (€0.01/€0.02) [ADM ID: M62C63044C87BABT] - 2025/10/15 1:01:51 CET [2025/10/14 19:01:51 ET]
Table 'Sirio' 6-max Seat #1 is the button
Seat 1: Warterror90 (€4.44 in chips) 
Seat 2: bv0360 (€1.30 in chips) 
Seat 3: ADRIAN0_MEIS (€4.90 in chips) 
Seat 4: uziu47 (€1.07 in chips) 
Seat 5: caduceus369 (€3.01 in chips) 
Seat 6: Trezvenik93 (€3 in chips) 
bv0360: posts small blind €0.01
ADRIAN0_MEIS: posts big blind €0.02
*** HOLE CARDS ***
Dealt to caduceus369 [Ad 3s]
uziu47: calls €0.02
caduceus369: folds 
Trezvenik93: calls €0.02
Warterror90: raises €0.04 to €0.06
bv0360: calls €0.05
ADRIAN0_MEIS: folds 
uziu47: calls €0.04
Trezvenik93: calls €0.04
*** FLOP *** [8c Kd 5d]
bv0360: checks 
uziu47: bets €0.08
Trezvenik93: folds 
Warterror90: calls €0.08
bv0360: folds 
*** TURN *** [8c Kd 5d] [3c]
uziu47: bets €0.16
Warterror90: calls €0.16
*** RIVER *** [8c Kd 5d 3c] [4c]
uziu47: bets €0.26
Warterror90: folds 
Uncalled bet (€0.26) returned to uziu47
uziu47 collected €0.70 from pot
uziu47: doesn't show hand 
*** SUMMARY ***
Total pot €0.74 | Rake €0.04 
Board [8c Kd 5d 3c 4c]
Seat 1: Warterror90 (button) folded on the River
Seat 2: bv0360 (small blind) folded on the Flop
Seat 3: ADRIAN0_MEIS (big blind) folded before Flop
Seat 4: uziu47 collected (€0.70)
Seat 5: caduceus369 folded before Flop (didn't bet)
Seat 6: Trezvenik93 folded on the Flop



PokerStars Zoom Hand #258129096362:  Hold'em No Limit (€0.01/€0.02) [ADM ID: M62C63044C87BABT] - 2025/10/15 1:02:34 CET [2025/10/14 19:02:34 ET]
Table 'Sirio' 6-max Seat #1 is the button
Seat 1: dandoshats (€1.95 in chips) 
Seat 2: QUEEN-KING-QQKK (€1.68 in chips) 
Seat 3: EasyToRule (€2 in chips) 
Seat 4: caduceus369 (€2.98 in chips) 
Seat 5: Trezvenik93 (€2.94 in chips) 
Seat 6: bv0360 (€1.24 in chips) 
QUEEN-KING-QQKK: posts small blind €0.01
EasyToRule: posts big blind €0.02
*** HOLE CARDS ***
Dealt to caduceus369 [Kc Th]
caduceus369: raises €0.04 to €0.06
Trezvenik93: folds 
bv0360: calls €0.06
dandoshats: folds 
QUEEN-KING-QQKK: calls €0.05
EasyToRule: calls €0.04
*** FLOP *** [2d 4c Ks]
QUEEN-KING-QQKK: checks 
EasyToRule: checks 
caduceus369: bets €0.08
bv0360: folds 
QUEEN-KING-QQKK: folds 
EasyToRule: calls €0.08
*** TURN *** [2d 4c Ks] [6h]
EasyToRule: bets €0.03
caduceus369: calls €0.03
*** RIVER *** [2d 4c Ks 6h] [Td]
EasyToRule: bets €0.03
caduceus369: raises €0.63 to €0.66
EasyToRule: folds 
Uncalled bet (€0.63) returned to caduceus369
caduceus369 collected €0.50 from pot
caduceus369: doesn't show hand 
*** SUMMARY ***
Total pot €0.52 | Rake €0.02 
Board [2d 4c Ks 6h Td]
Seat 1: dandoshats (button) folded before Flop (didn't bet)
Seat 2: QUEEN-KING-QQKK (small blind) folded on the Flop
Seat 3: EasyToRule (big blind) folded on the River
Seat 4: caduceus369 collected (€0.50)
Seat 5: Trezvenik93 folded before Flop (didn't bet)
Seat 6: bv0360 folded on the Flop



PokerStars Zoom Hand #258129108989:  Hold'em No Limit (€0.01/€0.02) [ADM ID: M62C63044C87BABT] - 2025/10/15 1:03:45 CET [2025/10/14 19:03:45 ET]
Table 'Sirio' 6-max Seat #1 is the button
Seat 1: caduceus369 (€3.28 in chips) 
Seat 2: dandoshats (€1.98 in chips) 
Seat 3: mashallahh (€8.42 in chips) 
Seat 4: meteco79 (€1.40 in chips) 
Seat 5: EasyToRule (€2.59 in chips) 
dandoshats: posts small blind €0.01
mashallahh: posts big blind €0.02
*** HOLE CARDS ***
Dealt to caduceus369 [Kd Js]
meteco79: calls €0.02
EasyToRule: folds 
caduceus369: raises €0.04 to €0.06
dandoshats: raises €0.14 to €0.20
mashallahh: folds 
meteco79: calls €0.18
caduceus369: calls €0.14
*** FLOP *** [7c 9h 6h]
dandoshats: checks 
meteco79: bets €1.20 and is all-in
caduceus369: folds 
dandoshats: folds 
Uncalled bet (€1.20) returned to meteco79
meteco79 collected €0.59 from pot
meteco79: doesn't show hand 
*** SUMMARY ***
Total pot €0.62 | Rake €0.03 
Board [7c 9h 6h]
Seat 1: caduceus369 (button) folded on the Flop
Seat 2: dandoshats (small blind) folded on the Flop
Seat 3: mashallahh (big blind) folded before Flop
Seat 4: meteco79 collected (€0.59)
Seat 5: EasyToRule folded before Flop (didn't bet)



PokerStars Zoom Hand #258129114272:  Hold'em No Limit (€0.01/€0.02) [ADM ID: M62C63044C87BABT] - 2025/10/15 1:04:15 CET [2025/10/14 19:04:15 ET]
Table 'Sirio' 6-max Seat #1 is the button
Seat 1: bv0360 (€1.18 in chips) 
Seat 2: caduceus369 (€3.08 in chips) 
Seat 3: Trezvenik93 (€2.86 in chips) 
Seat 4: dandoshats (€1.78 in chips) 
Seat 5: mashallahh (€8.15 in chips) 
caduceus369: posts small blind €0.01
Trezvenik93: posts big blind €0.02
*** HOLE CARDS ***
Dealt to caduceus369 [Qd Kd]
dandoshats: raises €0.04 to €0.06
mashallahh: folds 
bv0360 has timed out
bv0360: folds 
caduceus369: calls €0.05
Trezvenik93: folds 
*** FLOP *** [5c Tc Kc]
caduceus369: checks 
dandoshats: bets €0.08
caduceus369: calls €0.08
*** TURN *** [5c Tc Kc] [4s]
caduceus369: checks 
dandoshats: checks 
*** RIVER *** [5c Tc Kc 4s] [Qh]
caduceus369: bets €0.15
dandoshats: raises €1.49 to €1.64 and is all-in
caduceus369: folds 
Uncalled bet (€1.49) returned to dandoshats
dandoshats collected €0.57 from pot
dandoshats: doesn't show hand 
*** SUMMARY ***
Total pot €0.60 | Rake €0.03 
Board [5c Tc Kc 4s Qh]
Seat 1: bv0360 (button) folded before Flop (didn't bet)
Seat 2: caduceus369 (small blind) folded on the River
Seat 3: Trezvenik93 (big blind) folded before Flop
Seat 4: dandoshats collected (€0.57)
Seat 5: mashallahh folded before Flop (didn't bet)



PokerStars Zoom Hand #258129129282:  Hold'em No Limit (€0.01/€0.02) [ADM ID: M62C63044C87BABT] - 2025/10/15 1:05:39 CET [2025/10/14 19:05:39 ET]
Table 'Sirio' 6-max Seat #1 is the button
Seat 1: dandoshats (€2.18 in chips) 
Seat 2: QUEEN-KING-QQKK (€2.72 in chips) 
Seat 3: mashallahh (€8.15 in chips) 
Seat 4: Trezvenik93 (€2.75 in chips) 
Seat 5: caduceus369 (€2.79 in chips) 
QUEEN-KING-QQKK: posts small blind €0.01
mashallahh: posts big blind €0.02
*** HOLE CARDS ***
Dealt to caduceus369 [4d Qd]
Trezvenik93: folds 
caduceus369: folds 
dandoshats: folds 
QUEEN-KING-QQKK: folds 
Uncalled bet (€0.01) returned to mashallahh
mashallahh collected €0.02 from pot
mashallahh: doesn't show hand 
*** SUMMARY ***
Total pot €0.02 | Rake €0 
Seat 1: dandoshats (button) folded before Flop (didn't bet)
Seat 2: QUEEN-KING-QQKK (small blind) folded before Flop
Seat 3: mashallahh (big blind) collected (€0.02)
Seat 4: Trezvenik93 folded before Flop (didn't bet)
Seat 5: caduceus369 folded before Flop (didn't bet)



PokerStars Zoom Hand #258129130158:  Hold'em No Limit (€0.01/€0.02) [ADM ID: M62C63044C87BABT] - 2025/10/15 1:05:44 CET [2025/10/14 19:05:44 ET]
Table 'Sirio' 6-max Seat #1 is the button
Seat 1: ilteatro131 (€1.52 in chips) 
Seat 2: CIKO71131 (€0.78 in chips) 
Seat 3: caduceus369 (€2.79 in chips) 
Seat 4: dandoshats (€2.06 in chips) 
Seat 5: QUEEN-KING-QQKK (€1.55 in chips) 
CIKO71131: posts small blind €0.01
caduceus369: posts big blind €0.02
*** HOLE CARDS ***
Dealt to caduceus369 [Th Ad]
dandoshats: folds 
QUEEN-KING-QQKK: raises €0.05 to €0.07
ilteatro131: folds 
CIKO71131: folds 
caduceus369: calls €0.05
*** FLOP *** [7s Kc 9s]
caduceus369: checks 
QUEEN-KING-QQKK: checks 
*** TURN *** [7s Kc 9s] [4s]
caduceus369: checks 
QUEEN-KING-QQKK: checks 
*** RIVER *** [7s Kc 9s 4s] [3s]
caduceus369: bets €0.04
QUEEN-KING-QQKK: calls €0.04
*** SHOW DOWN ***
caduceus369: shows [Th Ad] (high card Ace)
QUEEN-KING-QQKK: shows [8s 7h] (a flush, Nine high)
QUEEN-KING-QQKK collected €0.22 from pot
*** SUMMARY ***
Total pot €0.23 | Rake €0.01 
Board [7s Kc 9s 4s 3s]
Seat 1: ilteatro131 (button) folded before Flop (didn't bet)
Seat 2: CIKO71131 (small blind) folded before Flop
Seat 3: caduceus369 (big blind) showed [Th Ad] and lost with high card Ace
Seat 4: dandoshats folded before Flop (didn't bet)
Seat 5: QUEEN-KING-QQKK showed [8s 7h] and won (€0.22) with a flush, Nine high



PokerStars Zoom Hand #258129135612:  Hold'em No Limit (€0.01/€0.02) [ADM ID: M62C63044C87BABT] - 2025/10/15 1:06:15 CET [2025/10/14 19:06:15 ET]
Table 'Sirio' 6-max Seat #1 is the button
Seat 1: caduceus369 (€2.68 in chips) 
Seat 2: EasyToRule (€2.36 in chips) 
Seat 3: QUEEN-KING-QQKK (€2.64 in chips) 
Seat 4: Poetto65 (€0.70 in chips) 
Seat 5: father2008 (€2.15 in chips) 
EasyToRule: posts small blind €0.01
QUEEN-KING-QQKK: posts big blind €0.02
*** HOLE CARDS ***
Dealt to caduceus369 [Js Kh]
Poetto65: folds 
father2008: folds 
caduceus369: raises €0.04 to €0.06
EasyToRule: folds 
QUEEN-KING-QQKK: folds 
Uncalled bet (€0.04) returned to caduceus369
caduceus369 collected €0.05 from pot
caduceus369: doesn't show hand 
*** SUMMARY ***
Total pot €0.05 | Rake €0 
Seat 1: caduceus369 (button) collected (€0.05)
Seat 2: EasyToRule (small blind) folded before Flop
Seat 3: QUEEN-KING-QQKK (big blind) folded before Flop
Seat 4: Poetto65 folded before Flop (didn't bet)
Seat 5: father2008 folded before Flop (didn't bet)



PokerStars Zoom Hand #258129134536:  Hold'em No Limit (€0.01/€0.02) [ADM ID: M62C63044C87BABT] - 2025/10/15 1:06:09 CET [2025/10/14 19:06:09 ET]
Table 'Sirio' 6-max Seat #1 is the button
Seat 1: Trezvenik93 (€2.47 in chips) 
Seat 2: meteco79 (€1.78 in chips) 
Seat 3: mashallahh (€8.41 in chips) 
Seat 4: caduceus369 (€2.68 in chips) 
Seat 5: father2008 (€2.15 in chips) 
meteco79: posts small blind €0.01
mashallahh: posts big blind €0.02
*** HOLE CARDS ***
Dealt to caduceus369 [Jh 4c]
caduceus369: folds 
father2008: folds 
Trezvenik93: folds 
meteco79: calls €0.01
mashallahh: checks 
*** FLOP *** [8d 3c Qd]
meteco79: checks 
mashallahh: checks 
*** TURN *** [8d 3c Qd] [5c]
meteco79: checks 
mashallahh: bets €0.02
meteco79: calls €0.02
*** RIVER *** [8d 3c Qd 5c] [4d]
meteco79: checks 
mashallahh: checks 
*** SHOW DOWN ***
meteco79: shows [6c 5s] (a pair of Fives)
mashallahh: shows [7h 6s] (a straight, Four to Eight)
mashallahh collected €0.08 from pot
*** SUMMARY ***
Total pot €0.08 | Rake €0 
Board [8d 3c Qd 5c 4d]
Seat 1: Trezvenik93 (button) folded before Flop (didn't bet)
Seat 2: meteco79 (small blind) showed [6c 5s] and lost with a pair of Fives
Seat 3: mashallahh (big blind) showed [7h 6s] and won (€0.08) with a straight, Four to Eight
Seat 4: caduceus369 folded before Flop (didn't bet)
Seat 5: father2008 folded before Flop (didn't bet)



PokerStars Zoom Hand #258129139639:  Hold'em No Limit (€0.01/€0.02) [ADM ID: M62C63044C87BABT] - 2025/10/15 1:06:39 CET [2025/10/14 19:06:39 ET]
Table 'Sirio' 6-max Seat #1 is the button
Seat 1: Begimon (€11.32 in chips) 
Seat 2: ilteatro131 (€1.47 in chips) 
Seat 3: QUEEN-KING-QQKK (€1.74 in chips) 
Seat 4: Poetto65 (€0.70 in chips) 
Seat 5: caduceus369 (€2.71 in chips) 
Seat 6: father2008 (€2.31 in chips) 
ilteatro131: posts small blind €0.01
QUEEN-KING-QQKK: posts big blind €0.02
*** HOLE CARDS ***
Dealt to caduceus369 [Qc Ks]
Poetto65: folds 
caduceus369: raises €0.04 to €0.06
father2008: raises €0.12 to €0.18
Begimon: folds 
ilteatro131: calls €0.17
QUEEN-KING-QQKK: folds 
caduceus369: calls €0.12
*** FLOP *** [Th 3s 5d]
ilteatro131: checks 
caduceus369: checks 
father2008: checks 
*** TURN *** [Th 3s 5d] [Ts]
ilteatro131: bets €0.02
caduceus369: calls €0.02
father2008: calls €0.02
*** RIVER *** [Th 3s 5d Ts] [2c]
ilteatro131: checks 
caduceus369: checks 
father2008: checks 
*** SHOW DOWN ***
ilteatro131: shows [7h 5c] (two pair, Tens and Fives)
caduceus369: mucks hand 
father2008: mucks hand 
ilteatro131 collected €0.59 from pot
*** SUMMARY ***
Total pot €0.62 | Rake €0.03 
Board [Th 3s 5d Ts 2c]
Seat 1: Begimon (button) folded before Flop (didn't bet)
Seat 2: ilteatro131 (small blind) showed [7h 5c] and won (€0.59) with two pair, Tens and Fives
Seat 3: QUEEN-KING-QQKK (big blind) folded before Flop
Seat 4: Poetto65 folded before Flop (didn't bet)
Seat 5: caduceus369 mucked [Qc Ks]
Seat 6: father2008 mucked [Ac Jh]



PokerStars Zoom Hand #258129150038:  Hold'em No Limit (€0.01/€0.02) [ADM ID: M62C63044C87BABT] - 2025/10/15 1:07:39 CET [2025/10/14 19:07:39 ET]
Table 'Sirio' 6-max Seat #1 is the button
Seat 1: mashallahh (€7.92 in chips) 
Seat 2: father2008 (€2.11 in chips) 
Seat 3: caduceus369 (€2.51 in chips) 
Seat 4: ilteatro131 (€1.86 in chips) 
Seat 5: bv0360 (€0.80 in chips) 
Seat 6: Temait77728 (€2.20 in chips) 
father2008: posts small blind €0.01
caduceus369: posts big blind €0.02
*** HOLE CARDS ***
Dealt to caduceus369 [5c Ks]
ilteatro131: folds 
bv0360: raises €0.04 to €0.06
Temait77728: folds 
mashallahh: folds 
father2008: folds 
caduceus369: folds 
Uncalled bet (€0.04) returned to bv0360
bv0360 collected €0.05 from pot
bv0360: doesn't show hand 
*** SUMMARY ***
Total pot €0.05 | Rake €0 
Seat 1: mashallahh (button) folded before Flop (didn't bet)
Seat 2: father2008 (small blind) folded before Flop
Seat 3: caduceus369 (big blind) folded before Flop
Seat 4: ilteatro131 folded before Flop (didn't bet)
Seat 5: bv0360 collected (€0.05)
Seat 6: Temait77728 folded before Flop (didn't bet)



PokerStars Zoom Hand #258129151858:  Hold'em No Limit (€0.01/€0.02) [ADM ID: M62C63044C87BABT] - 2025/10/15 1:07:50 CET [2025/10/14 19:07:50 ET]
Table 'Sirio' 6-max Seat #1 is the button
Seat 1: bartolo608 (€1.97 in chips) 
Seat 2: caduceus369 (€2.49 in chips) 
Seat 3: uziu47 (€1.77 in chips) 
Seat 4: dandoshats (€3.16 in chips) 
Seat 5: Trezvenik93 (€2.38 in chips) 
Seat 6: ilteatro131 (€1.86 in chips) 
caduceus369: posts small blind €0.01
uziu47: posts big blind €0.02
*** HOLE CARDS ***
Dealt to caduceus369 [Kh 8h]
dandoshats: folds 
Trezvenik93: folds 
ilteatro131: raises €0.02 to €0.04
bartolo608: raises €0.06 to €0.10
caduceus369: folds 
uziu47: folds 
ilteatro131: calls €0.06
*** FLOP *** [7s Ts Ah]
ilteatro131: checks 
bartolo608: checks 
*** TURN *** [7s Ts Ah] [8c]
ilteatro131: bets €0.02
bartolo608: calls €0.02
*** RIVER *** [7s Ts Ah 8c] [Jh]
ilteatro131: checks 
bartolo608: bets €0.26
ilteatro131: folds 
Uncalled bet (€0.26) returned to bartolo608
bartolo608 collected €0.26 from pot
bartolo608: doesn't show hand 
*** SUMMARY ***
Total pot €0.27 | Rake €0.01 
Board [7s Ts Ah 8c Jh]
Seat 1: bartolo608 (button) collected (€0.26)
Seat 2: caduceus369 (small blind) folded before Flop
Seat 3: uziu47 (big blind) folded before Flop
Seat 4: dandoshats folded before Flop (didn't bet)
Seat 5: Trezvenik93 folded before Flop (didn't bet)
Seat 6: ilteatro131 folded on the River



PokerStars Zoom Hand #258129158641:  Hold'em No Limit (€0.01/€0.02) [ADM ID: M62C63044C87BABT] - 2025/10/15 1:08:30 CET [2025/10/14 19:08:30 ET]
Table 'Sirio' 6-max Seat #1 is the button
Seat 1: franck19621962 (€1.26 in chips) 
Seat 2: ilteatro131 (€1.74 in chips) 
Seat 3: Trezvenik93 (€2.40 in chips) 
Seat 4: mashallahh (€8.41 in chips) 
Seat 5: caduceus369 (€2.48 in chips) 
ilteatro131: posts small blind €0.01
Trezvenik93: posts big blind €0.02
*** HOLE CARDS ***
Dealt to caduceus369 [6h Kc]
mashallahh: folds 
caduceus369: folds 
franck19621962: calls €0.02
ilteatro131: folds 
Trezvenik93: checks 
*** FLOP *** [Ah 8s 4s]
Trezvenik93: checks 
franck19621962: bets €0.04
Trezvenik93: folds 
Uncalled bet (€0.04) returned to franck19621962
franck19621962 collected €0.05 from pot
franck19621962: doesn't show hand 
*** SUMMARY ***
Total pot €0.05 | Rake €0 
Board [Ah 8s 4s]
Seat 1: franck19621962 (button) collected (€0.05)
Seat 2: ilteatro131 (small blind) folded before Flop
Seat 3: Trezvenik93 (big blind) folded on the Flop
Seat 4: mashallahh folded before Flop (didn't bet)
Seat 5: caduceus369 folded before Flop (didn't bet)



PokerStars Zoom Hand #258129156698:  Hold'em No Limit (€0.01/€0.02) [ADM ID: M62C63044C87BABT] - 2025/10/15 1:08:18 CET [2025/10/14 19:08:18 ET]
Table 'Sirio' 6-max Seat #1 is the button
Seat 1: mashallahh (€8.41 in chips) 
Seat 2: father2008 (€2.13 in chips) 
Seat 3: QUEEN-KING-QQKK (€1.85 in chips) 
Seat 4: Warterror90 (€7.03 in chips) 
Seat 5: dandoshats (€3.23 in chips) 
Seat 6: caduceus369 (€2.48 in chips) 
father2008: posts small blind €0.01
QUEEN-KING-QQKK: posts big blind €0.02
*** HOLE CARDS ***
Dealt to caduceus369 [6c Th]
Warterror90: raises €0.04 to €0.06
dandoshats: raises €0.10 to €0.16
caduceus369: folds 
mashallahh: folds 
father2008: folds 
QUEEN-KING-QQKK: folds 
Warterror90: calls €0.10
*** FLOP *** [8d Ts 3h]
Warterror90: checks 
dandoshats: bets €0.08
Warterror90: folds 
Uncalled bet (€0.08) returned to dandoshats
dandoshats collected €0.34 from pot
dandoshats: doesn't show hand 
*** SUMMARY ***
Total pot €0.35 | Rake €0.01 
Board [8d Ts 3h]
Seat 1: mashallahh (button) folded before Flop (didn't bet)
Seat 2: father2008 (small blind) folded before Flop
Seat 3: QUEEN-KING-QQKK (big blind) folded before Flop
Seat 4: Warterror90 folded on the Flop
Seat 5: dandoshats collected (€0.34)
Seat 6: caduceus369 folded before Flop (didn't bet)



PokerStars Zoom Hand #258129154637:  Hold'em No Limit (€0.01/€0.02) [ADM ID: M62C63044C87BABT] - 2025/10/15 1:08:06 CET [2025/10/14 19:08:06 ET]
Table 'Sirio' 6-max Seat #1 is the button
Seat 1: caduceus369 (€2.48 in chips) 
Seat 2: EasyToRule (€2.34 in chips) 
Seat 3: mashallahh (€7.92 in chips) 
Seat 4: SebaRapy14 (€3.76 in chips) 
Seat 5: uziu47 (€1.75 in chips) 
EasyToRule: posts small blind €0.01
mashallahh: posts big blind €0.02
*** HOLE CARDS ***
Dealt to caduceus369 [Td 9d]
SebaRapy14: folds 
uziu47: calls €0.02
caduceus369: folds 
EasyToRule: calls €0.01
mashallahh: checks 
*** FLOP *** [Th As Ts]
EasyToRule: bets €0.03
mashallahh: calls €0.03
uziu47: folds 
*** TURN *** [Th As Ts] [5s]
EasyToRule: checks 
mashallahh: checks 
*** RIVER *** [Th As Ts 5s] [7h]
EasyToRule: bets €0.02
mashallahh: calls €0.02
*** SHOW DOWN ***
EasyToRule: shows [Ad 3d] (two pair, Aces and Tens)
mashallahh: shows [Ah 9s] (two pair, Aces and Tens - Nine kicker)
mashallahh collected €0.16 from pot
*** SUMMARY ***
Total pot €0.16 | Rake €0 
Board [Th As Ts 5s 7h]
Seat 1: caduceus369 (button) folded before Flop (didn't bet)
Seat 2: EasyToRule (small blind) showed [Ad 3d] and lost with two pair, Aces and Tens
Seat 3: mashallahh (big blind) showed [Ah 9s] and won (€0.16) with two pair, Aces and Tens
Seat 4: SebaRapy14 folded before Flop (didn't bet)
Seat 5: uziu47 folded on the Flop



PokerStars Zoom Hand #258129161014:  Hold'em No Limit (€0.01/€0.02) [ADM ID: M62C63044C87BABT] - 2025/10/15 1:08:44 CET [2025/10/14 19:08:44 ET]
Table 'Sirio' 6-max Seat #1 is the button
Seat 1: mashallahh (€8.41 in chips) 
Seat 2: caduceus369 (€2.48 in chips) 
Seat 3: bv0360 (€0.87 in chips) 
Seat 4: Trezvenik93 (€2.92 in chips) 
Seat 5: Warterror90 (€7.07 in chips) 
caduceus369: posts small blind €0.01
bv0360: posts big blind €0.02
*** HOLE CARDS ***
Dealt to caduceus369 [6s 8d]
Trezvenik93: raises €0.03 to €0.05
Warterror90: folds 
mashallahh: folds 
caduceus369: folds 
bv0360: calls €0.03
*** FLOP *** [6c 5d 7c]
bv0360: bets €0.02
Trezvenik93: folds 
Uncalled bet (€0.02) returned to bv0360
bv0360 collected €0.11 from pot
bv0360: doesn't show hand 
*** SUMMARY ***
Total pot €0.11 | Rake €0 
Board [6c 5d 7c]
Seat 1: mashallahh (button) folded before Flop (didn't bet)
Seat 2: caduceus369 (small blind) folded before Flop
Seat 3: bv0360 (big blind) collected (€0.11)
Seat 4: Trezvenik93 folded on the Flop
Seat 5: Warterror90 folded before Flop (didn't bet)



PokerStars Zoom Hand #258129163738:  Hold'em No Limit (€0.01/€0.02) [ADM ID: M62C63044C87BABT] - 2025/10/15 1:09:00 CET [2025/10/14 19:09:00 ET]
Table 'Sirio' 6-max Seat #1 is the button
Seat 1: meteco79 (€1.59 in chips) 
Seat 2: mashallahh (€8.01 in chips) 
Seat 3: caduceus369 (€2.47 in chips) 
Seat 4: dandoshats (€3.40 in chips) 
Seat 5: CIKO71131 (€0.55 in chips) 
mashallahh: posts small blind €0.01
caduceus369: posts big blind €0.02
*** HOLE CARDS ***
Dealt to caduceus369 [6d Qd]
dandoshats: raises €0.04 to €0.06
CIKO71131: folds 
meteco79: calls €0.06
mashallahh: folds 
caduceus369: folds 
*** FLOP *** [5s 2c Kd]
dandoshats: bets €0.05
meteco79: calls €0.05
*** TURN *** [5s 2c Kd] [9s]
dandoshats: checks 
meteco79: bets €1.48 and is all-in
dandoshats: folds 
Uncalled bet (€1.48) returned to meteco79
meteco79 collected €0.24 from pot
meteco79: doesn't show hand 
*** SUMMARY ***
Total pot €0.25 | Rake €0.01 
Board [5s 2c Kd 9s]
Seat 1: meteco79 (button) collected (€0.24)
Seat 2: mashallahh (small blind) folded before Flop
Seat 3: caduceus369 (big blind) folded before Flop
Seat 4: dandoshats folded on the Turn
Seat 5: CIKO71131 folded before Flop (didn't bet)



PokerStars Zoom Hand #258129159973:  Hold'em No Limit (€0.01/€0.02) [ADM ID: M62C63044C87BABT] - 2025/10/15 1:08:38 CET [2025/10/14 19:08:38 ET]
Table 'Sirio' 6-max Seat #1 is the button
Seat 1: ilteatro131 (€1.73 in chips) 
Seat 2: QUEEN-KING-QQKK (€2.82 in chips) 
Seat 3: CIKO71131 (€1.08 in chips) 
Seat 4: caduceus369 (€2.48 in chips) 
Seat 5: mashallahh (€8.41 in chips) 
QUEEN-KING-QQKK: posts small blind €0.01
CIKO71131: posts big blind €0.02
*** HOLE CARDS ***
Dealt to caduceus369 [Kc 6c]
caduceus369: folds 
mashallahh: folds 
ilteatro131: calls €0.02
QUEEN-KING-QQKK: calls €0.01
CIKO71131: checks 
*** FLOP *** [Ad Th 7s]
QUEEN-KING-QQKK: bets €0.04
CIKO71131: calls €0.04
ilteatro131: calls €0.04
*** TURN *** [Ad Th 7s] [3c]
QUEEN-KING-QQKK: bets €0.06
CIKO71131: calls €0.06
ilteatro131: calls €0.06
*** RIVER *** [Ad Th 7s 3c] [As]
QUEEN-KING-QQKK: bets €0.18
CIKO71131: folds 
ilteatro131: calls €0.18
*** SHOW DOWN ***
QUEEN-KING-QQKK: shows [5d Ac] (three of a kind, Aces)
ilteatro131: mucks hand 
QUEEN-KING-QQKK collected €0.69 from pot
*** SUMMARY ***
Total pot €0.72 | Rake €0.03 
Board [Ad Th 7s 3c As]
Seat 1: ilteatro131 (button) mucked [8s Tc]
Seat 2: QUEEN-KING-QQKK (small blind) showed [5d Ac] and won (€0.69) with three of a kind, Aces
Seat 3: CIKO71131 (big blind) folded on the River
Seat 4: caduceus369 folded before Flop (didn't bet)
Seat 5: mashallahh folded before Flop (didn't bet)



PokerStars Zoom Hand #258129162473:  Hold'em No Limit (€0.01/€0.02) [ADM ID: M62C63044C87BABT] - 2025/10/15 1:08:52 CET [2025/10/14 19:08:52 ET]
Table 'Sirio' 6-max Seat #1 is the button
Seat 1: QUEEN-KING-QQKK (€1.83 in chips) 
Seat 2: uziu47 (€1.74 in chips) 
Seat 3: mashallahh (€8.41 in chips) 
Seat 4: caduceus369 (€2.47 in chips) 
Seat 5: Trezvenik93 (€2.38 in chips) 
Seat 6: EasyToRule (€2 in chips) 
uziu47: posts small blind €0.01
mashallahh: posts big blind €0.02
*** HOLE CARDS ***
Dealt to caduceus369 [4d Kc]
caduceus369: folds 
Trezvenik93: raises €0.03 to €0.05
EasyToRule: folds 
QUEEN-KING-QQKK: folds 
uziu47: calls €0.04
mashallahh: folds 
*** FLOP *** [Jd Ac 7h]
uziu47: checks 
Trezvenik93: bets €0.08
uziu47: folds 
Uncalled bet (€0.08) returned to Trezvenik93
Trezvenik93 collected €0.12 from pot
Trezvenik93: doesn't show hand 
*** SUMMARY ***
Total pot €0.12 | Rake €0 
Board [Jd Ac 7h]
Seat 1: QUEEN-KING-QQKK (button) folded before Flop (didn't bet)
Seat 2: uziu47 (small blind) folded on the Flop
Seat 3: mashallahh (big blind) folded before Flop
Seat 4: caduceus369 folded before Flop (didn't bet)
Seat 5: Trezvenik93 collected (€0.12)
Seat 6: EasyToRule folded before Flop (didn't bet)



PokerStars Zoom Hand #258129167311:  Hold'em No Limit (€0.01/€0.02) [ADM ID: M62C63044C87BABT] - 2025/10/15 1:09:21 CET [2025/10/14 19:09:21 ET]
Table 'Sirio' 6-max Seat #1 is the button
Seat 1: father2008 (€2 in chips) 
Seat 2: dandoshats (€3.29 in chips) 
Seat 3: caduceus369 (€2.45 in chips) 
Seat 4: miridersa (€1.34 in chips) 
Seat 5: mashallahh (€8 in chips) 
dandoshats: posts small blind €0.01
caduceus369: posts big blind €0.02
*** HOLE CARDS ***
Dealt to caduceus369 [3s 6h]
miridersa: folds 
mashallahh: folds 
father2008: folds 
dandoshats: folds 
Uncalled bet (€0.01) returned to caduceus369
caduceus369 collected €0.02 from pot
caduceus369: doesn't show hand 
*** SUMMARY ***
Total pot €0.02 | Rake €0 
Seat 1: father2008 (button) folded before Flop (didn't bet)
Seat 2: dandoshats (small blind) folded before Flop
Seat 3: caduceus369 (big blind) collected (€0.02)
Seat 4: miridersa folded before Flop (didn't bet)
Seat 5: mashallahh folded before Flop (didn't bet)



PokerStars Zoom Hand #258129165215:  Hold'em No Limit (€0.01/€0.02) [ADM ID: M62C63044C87BABT] - 2025/10/15 1:09:09 CET [2025/10/14 19:09:09 ET]
Table 'Sirio' 6-max Seat #1 is the button
Seat 1: EasyToRule (€2.27 in chips) 
Seat 2: mashallahh (€2.82 in chips) 
Seat 3: Warterror90 (€7.10 in chips) 
Seat 4: caduceus369 (€2.45 in chips) 
Seat 5: franck19621962 (€1.28 in chips) 
mashallahh: posts small blind €0.01
Warterror90: posts big blind €0.02
*** HOLE CARDS ***
Dealt to caduceus369 [Ad 4h]
caduceus369: folds 
franck19621962: calls €0.02
EasyToRule: folds 
mashallahh: folds 
Warterror90: checks 
*** FLOP *** [Jh Kd 9c]
Warterror90: checks 
franck19621962: checks 
*** TURN *** [Jh Kd 9c] [8d]
Warterror90: bets €0.03
franck19621962: calls €0.03
*** RIVER *** [Jh Kd 9c 8d] [4d]
Warterror90: checks 
franck19621962: checks 
*** SHOW DOWN ***
Warterror90: shows [9d 7s] (a pair of Nines)
franck19621962: mucks hand 
Warterror90 collected €0.11 from pot
*** SUMMARY ***
Total pot €0.11 | Rake €0 
Board [Jh Kd 9c 8d 4d]
Seat 1: EasyToRule (button) folded before Flop (didn't bet)
Seat 2: mashallahh (small blind) folded before Flop
Seat 3: Warterror90 (big blind) showed [9d 7s] and won (€0.11) with a pair of Nines
Seat 4: caduceus369 folded before Flop (didn't bet)
Seat 5: franck19621962 mucked [Ah Td]



PokerStars Zoom Hand #258129170021:  Hold'em No Limit (€0.01/€0.02) [ADM ID: M62C63044C87BABT] - 2025/10/15 1:09:37 CET [2025/10/14 19:09:37 ET]
Table 'Sirio' 6-max Seat #1 is the button
Seat 1: caduceus369 (€2.46 in chips) 
Seat 2: Warterror90 (€6.49 in chips) 
Seat 3: Temait77728 (€2.31 in chips) 
Seat 4: father2008 (€2.47 in chips) 
Seat 5: mashallahh (€8 in chips) 
Warterror90: posts small blind €0.01
Temait77728: posts big blind €0.02
*** HOLE CARDS ***
Dealt to caduceus369 [9s 6s]
father2008: folds 
mashallahh: folds 
caduceus369: folds 
Warterror90: raises €0.04 to €0.06
Temait77728: calls €0.04
*** FLOP *** [Qc 7h 6d]
Warterror90: checks 
Temait77728: checks 
*** TURN *** [Qc 7h 6d] [Kd]
Warterror90: bets €0.04
Temait77728: calls €0.04
*** RIVER *** [Qc 7h 6d Kd] [Jd]
Warterror90: bets €0.08
Temait77728: raises €0.27 to €0.35
Warterror90: calls €0.27
*** SHOW DOWN ***
Temait77728: shows [Td 5d] (a flush, King high)
Warterror90: mucks hand 
Temait77728 collected €0.86 from pot
*** SUMMARY ***
Total pot €0.90 | Rake €0.04 
Board [Qc 7h 6d Kd Jd]
Seat 1: caduceus369 (button) folded before Flop (didn't bet)
Seat 2: Warterror90 (small blind) mucked [As Kh]
Seat 3: Temait77728 (big blind) showed [Td 5d] and won (€0.86) with a flush, King high
Seat 4: father2008 folded before Flop (didn't bet)
Seat 5: mashallahh folded before Flop (didn't bet)



PokerStars Zoom Hand #258129171237:  Hold'em No Limit (€0.01/€0.02) [ADM ID: M62C63044C87BABT] - 2025/10/15 1:09:44 CET [2025/10/14 19:09:44 ET]
Table 'Sirio' 6-max Seat #1 is the button
Seat 1: ADRIAN0_MEIS (€5.50 in chips) 
Seat 2: caduceus369 (€2.46 in chips) 
Seat 3: father2008 (€2.47 in chips) 
Seat 4: mashallahh (€8.38 in chips) 
Seat 5: meteco79 (€1.73 in chips) 
caduceus369: posts small blind €0.01
father2008: posts big blind €0.02
*** HOLE CARDS ***
Dealt to caduceus369 [Kh Qh]
mashallahh: folds 
meteco79: calls €0.02
ADRIAN0_MEIS: calls €0.02
caduceus369: raises €0.06 to €0.08
father2008: folds 
meteco79: calls €0.06
ADRIAN0_MEIS: folds 
*** FLOP *** [Qc 5d Ks]
caduceus369: checks 
meteco79: bets €0.19
caduceus369: raises €0.19 to €0.38
meteco79: calls €0.19
*** TURN *** [Qc 5d Ks] [As]
caduceus369: checks 
meteco79: checks 
*** RIVER *** [Qc 5d Ks As] [Ah]
caduceus369: bets €0.30
meteco79: calls €0.30
*** SHOW DOWN ***
caduceus369: shows [Kh Qh] (two pair, Aces and Kings)
meteco79: mucks hand 
caduceus369 collected €1.48 from pot
*** SUMMARY ***
Total pot €1.56 | Rake €0.08 
Board [Qc 5d Ks As Ah]
Seat 1: ADRIAN0_MEIS (button) folded before Flop
Seat 2: caduceus369 (small blind) showed [Kh Qh] and won (€1.48) with two pair, Aces and Kings
Seat 3: father2008 (big blind) folded before Flop
Seat 4: mashallahh folded before Flop (didn't bet)
Seat 5: meteco79 mucked [Qd Th]



PokerStars Zoom Hand #258129179779:  Hold'em No Limit (€0.01/€0.02) [ADM ID: M62C63044C87BABT] - 2025/10/15 1:10:36 CET [2025/10/14 19:10:36 ET]
Table 'Sirio' 6-max Seat #1 is the button
Seat 1: ormaxam (€1.95 in chips) 
Seat 2: EasyToRule (€2.19 in chips) 
Seat 3: ADRIAN0_MEIS (€5.46 in chips) 
Seat 4: dandoshats (€2.03 in chips) 
Seat 5: caduceus369 (€3.18 in chips) 
Seat 6: meteco79 (€0.97 in chips) 
EasyToRule: posts small blind €0.01
ADRIAN0_MEIS: posts big blind €0.02
*** HOLE CARDS ***
Dealt to caduceus369 [Ad Tc]
dandoshats: raises €0.04 to €0.06
caduceus369: raises €0.12 to €0.18
meteco79: folds 
ormaxam: folds 
EasyToRule: folds 
ADRIAN0_MEIS: folds 
dandoshats: calls €0.12
*** FLOP *** [Jc 2h 8d]
dandoshats: checks 
caduceus369: bets €0.17
dandoshats: folds 
Uncalled bet (€0.17) returned to caduceus369
caduceus369 collected €0.37 from pot
caduceus369: doesn't show hand 
*** SUMMARY ***
Total pot €0.39 | Rake €0.02 
Board [Jc 2h 8d]
Seat 1: ormaxam (button) folded before Flop (didn't bet)
Seat 2: EasyToRule (small blind) folded before Flop
Seat 3: ADRIAN0_MEIS (big blind) folded before Flop
Seat 4: dandoshats folded on the Flop
Seat 5: caduceus369 collected (€0.37)
Seat 6: meteco79 folded before Flop (didn't bet)



PokerStars Zoom Hand #258129186169:  Hold'em No Limit (€0.01/€0.02) [ADM ID: M62C63044C87BABT] - 2025/10/15 1:11:14 CET [2025/10/14 19:11:14 ET]
Table 'Sirio' 6-max Seat #1 is the button
Seat 1: dandoshats (€1.84 in chips) 
Seat 2: Begimon (€11.10 in chips) 
Seat 3: miridersa (€1.23 in chips) 
Seat 4: caduceus369 (€3.37 in chips) 
Seat 5: EasyToRule (€2.23 in chips) 
Begimon: posts small blind €0.01
miridersa: posts big blind €0.02
*** HOLE CARDS ***
Dealt to caduceus369 [6s Ac]
caduceus369: folds 
EasyToRule: folds 
dandoshats: raises €0.02 to €0.04
Begimon: folds 
miridersa: calls €0.02
*** FLOP *** [5d Td 5h]
miridersa: checks 
dandoshats: bets €0.04
miridersa: folds 
Uncalled bet (€0.04) returned to dandoshats
dandoshats collected €0.09 from pot
dandoshats: doesn't show hand 
*** SUMMARY ***
Total pot €0.09 | Rake €0 
Board [5d Td 5h]
Seat 1: dandoshats (button) collected (€0.09)
Seat 2: Begimon (small blind) folded before Flop
Seat 3: miridersa (big blind) folded on the Flop
Seat 4: caduceus369 folded before Flop (didn't bet)
Seat 5: EasyToRule folded before Flop (didn't bet)



PokerStars Zoom Hand #258129186931:  Hold'em No Limit (€0.01/€0.02) [ADM ID: M62C63044C87BABT] - 2025/10/15 1:11:18 CET [2025/10/14 19:11:18 ET]
Table 'Sirio' 6-max Seat #1 is the button
Seat 1: caduceus369 (€3.37 in chips) 
Seat 2: Warterror90 (€5.98 in chips) 
Seat 3: CIKO71131 (€0.94 in chips) 
Seat 4: mashallahh (€7.95 in chips) 
Seat 5: dandoshats (€3.40 in chips) 
Seat 6: QUEEN-KING-QQKK (€1.76 in chips) 
Warterror90: posts small blind €0.01
CIKO71131: posts big blind €0.02
*** HOLE CARDS ***
Dealt to caduceus369 [Jd Jh]
mashallahh: folds 
dandoshats: raises €0.05 to €0.07
QUEEN-KING-QQKK: folds 
caduceus369: raises €0.11 to €0.18
Warterror90: folds 
CIKO71131: folds 
dandoshats: calls €0.11
*** FLOP *** [Qs 2h 3h]
dandoshats: checks 
caduceus369: bets €0.12
dandoshats: raises €0.21 to €0.33
caduceus369: calls €0.21
*** TURN *** [Qs 2h 3h] [6s]
dandoshats: bets €0.35
caduceus369: folds 
Uncalled bet (€0.35) returned to dandoshats
dandoshats collected €1 from pot
dandoshats: doesn't show hand 
*** SUMMARY ***
Total pot €1.05 | Rake €0.05 
Board [Qs 2h 3h 6s]
Seat 1: caduceus369 (button) folded on the Turn
Seat 2: Warterror90 (small blind) folded before Flop
Seat 3: CIKO71131 (big blind) folded before Flop
Seat 4: mashallahh folded before Flop (didn't bet)
Seat 5: dandoshats collected (€1)
Seat 6: QUEEN-KING-QQKK folded before Flop (didn't bet)



PokerStars Zoom Hand #258129197743:  Hold'em No Limit (€0.01/€0.02) [ADM ID: M62C63044C87BABT] - 2025/10/15 1:12:22 CET [2025/10/14 19:12:22 ET]
Table 'Sirio' 6-max Seat #1 is the button
Seat 1: ilteatro131 (€1.41 in chips) 
Seat 2: caduceus369 (€2.86 in chips) 
Seat 3: mashallahh (€7.97 in chips) 
Seat 4: father2008 (€2.40 in chips) 
Seat 5: Poetto65 (€0.61 in chips) 
Seat 6: ormaxam (€2.21 in chips) 
caduceus369: posts small blind €0.01
mashallahh: posts big blind €0.02
*** HOLE CARDS ***
Dealt to caduceus369 [Qc 3h]
father2008: folds 
Poetto65: folds 
ormaxam: raises €0.04 to €0.06
ilteatro131: calls €0.06
caduceus369: folds 
mashallahh: folds 
*** FLOP *** [Kc Qd 2h]
ormaxam: checks 
ilteatro131: checks 
*** TURN *** [Kc Qd 2h] [6c]
ormaxam: checks 
ilteatro131: checks 
*** RIVER *** [Kc Qd 2h 6c] [Kh]
ormaxam: checks 
ilteatro131: checks 
*** SHOW DOWN ***
ormaxam: shows [4c Ad] (a pair of Kings)
ilteatro131: mucks hand 
ormaxam collected €0.15 from pot
*** SUMMARY ***
Total pot €0.15 | Rake €0 
Board [Kc Qd 2h 6c Kh]
Seat 1: ilteatro131 (button) mucked [7h 9h]
Seat 2: caduceus369 (small blind) folded before Flop
Seat 3: mashallahh (big blind) folded before Flop
Seat 4: father2008 folded before Flop (didn't bet)
Seat 5: Poetto65 folded before Flop (didn't bet)
Seat 6: ormaxam showed [4c Ad] and won (€0.15) with a pair of Kings



PokerStars Zoom Hand #258129200396:  Hold'em No Limit (€0.01/€0.02) [ADM ID: M62C63044C87BABT] - 2025/10/15 1:12:38 CET [2025/10/14 19:12:38 ET]
Table 'Sirio' 6-max Seat #1 is the button
Seat 1: CIKO71131 (€0.89 in chips) 
Seat 2: mashallahh (€7.95 in chips) 
Seat 3: caduceus369 (€2.85 in chips) 
Seat 4: Poetto65 (€0.61 in chips) 
Seat 5: bartolo608 (€2.13 in chips) 
Seat 6: BiscottinoXXL (€1.92 in chips) 
mashallahh: posts small blind €0.01
caduceus369: posts big blind €0.02
*** HOLE CARDS ***
Dealt to caduceus369 [Jd 8d]
Poetto65: raises €0.02 to €0.04
bartolo608: folds 
BiscottinoXXL: folds 
CIKO71131: folds 
mashallahh: folds 
caduceus369: folds 
Uncalled bet (€0.02) returned to Poetto65
Poetto65 collected €0.05 from pot
Poetto65: doesn't show hand 
*** SUMMARY ***
Total pot €0.05 | Rake €0 
Seat 1: CIKO71131 (button) folded before Flop (didn't bet)
Seat 2: mashallahh (small blind) folded before Flop
Seat 3: caduceus369 (big blind) folded before Flop
Seat 4: Poetto65 collected (€0.05)
Seat 5: bartolo608 folded before Flop (didn't bet)
Seat 6: BiscottinoXXL folded before Flop (didn't bet)



PokerStars Zoom Hand #258129196595:  Hold'em No Limit (€0.01/€0.02) [ADM ID: M62C63044C87BABT] - 2025/10/15 1:12:15 CET [2025/10/14 19:12:15 ET]
Table 'Sirio' 6-max Seat #1 is the button
Seat 1: EasyToRule (€2.28 in chips) 
Seat 2: Poetto65 (€0.62 in chips) 
Seat 3: BiscottinoXXL (€1.94 in chips) 
Seat 4: QUEEN-KING-QQKK (€1.80 in chips) 
Seat 5: caduceus369 (€2.86 in chips) 
Seat 6: bartolo608 (€2.15 in chips) 
Poetto65: posts small blind €0.01
BiscottinoXXL: posts big blind €0.02
*** HOLE CARDS ***
Dealt to caduceus369 [Qd 7d]
QUEEN-KING-QQKK: raises €0.05 to €0.07
caduceus369: folds 
bartolo608: folds 
EasyToRule: calls €0.07
Poetto65: folds 
BiscottinoXXL: folds 
*** FLOP *** [2c Kd 4s]
QUEEN-KING-QQKK: checks 
EasyToRule: bets €0.05
QUEEN-KING-QQKK: calls €0.05
*** TURN *** [2c Kd 4s] [Jd]
QUEEN-KING-QQKK: checks 
EasyToRule: checks 
*** RIVER *** [2c Kd 4s Jd] [As]
QUEEN-KING-QQKK: bets €0.13
EasyToRule: folds 
Uncalled bet (€0.13) returned to QUEEN-KING-QQKK
QUEEN-KING-QQKK collected €0.26 from pot
QUEEN-KING-QQKK: doesn't show hand 
*** SUMMARY ***
Total pot €0.27 | Rake €0.01 
Board [2c Kd 4s Jd As]
Seat 1: EasyToRule (button) folded on the River
Seat 2: Poetto65 (small blind) folded before Flop
Seat 3: BiscottinoXXL (big blind) folded before Flop
Seat 4: QUEEN-KING-QQKK collected (€0.26)
Seat 5: caduceus369 folded before Flop (didn't bet)
Seat 6: bartolo608 folded before Flop (didn't bet)



PokerStars Zoom Hand #258129203399:  Hold'em No Limit (€0.01/€0.02) [ADM ID: M62C63044C87BABT] - 2025/10/15 1:12:57 CET [2025/10/14 19:12:57 ET]
Table 'Sirio' 6-max Seat #1 is the button
Seat 1: bv0360 (€0.96 in chips) 
Seat 2: dandoshats (€3.83 in chips) 
Seat 3: CIKO71131 (€0.89 in chips) 
Seat 4: ADRIAN0_MEIS (€5.38 in chips) 
Seat 5: mashallahh (€7.94 in chips) 
Seat 6: caduceus369 (€2.83 in chips) 
dandoshats: posts small blind €0.01
CIKO71131: posts big blind €0.02
*** HOLE CARDS ***
Dealt to caduceus369 [8d Ks]
ADRIAN0_MEIS: raises €0.05 to €0.07
mashallahh: folds 
caduceus369: folds 
bv0360: raises €0.89 to €0.96 and is all-in
dandoshats: folds 
CIKO71131: folds 
ADRIAN0_MEIS: calls €0.89
*** FLOP *** [Qs Th 4h]
*** TURN *** [Qs Th 4h] [As]
*** RIVER *** [Qs Th 4h As] [7h]
*** SHOW DOWN ***
ADRIAN0_MEIS: shows [Qd Qc] (three of a kind, Queens)
bv0360: shows [Ah Jd] (a pair of Aces)
ADRIAN0_MEIS collected €1.85 from pot
*** SUMMARY ***
Total pot €1.95 | Rake €0.10 
Board [Qs Th 4h As 7h]
Seat 1: bv0360 (button) showed [Ah Jd] and lost with a pair of Aces
Seat 2: dandoshats (small blind) folded before Flop
Seat 3: CIKO71131 (big blind) folded before Flop
Seat 4: ADRIAN0_MEIS showed [Qd Qc] and won (€1.85) with three of a kind, Queens
Seat 5: mashallahh folded before Flop (didn't bet)
Seat 6: caduceus369 folded before Flop (didn't bet)



PokerStars Zoom Hand #258129204736:  Hold'em No Limit (€0.01/€0.02) [ADM ID: M62C63044C87BABT] - 2025/10/15 1:13:04 CET [2025/10/14 19:13:04 ET]
Table 'Sirio' 6-max Seat #1 is the button
Seat 1: Begimon (€11.29 in chips) 
Seat 2: Macantoni (€0.79 in chips) 
Seat 3: mashallahh (€2.86 in chips) 
Seat 4: caduceus369 (€2.83 in chips) 
Seat 5: ormaxam (€2.29 in chips) 
Seat 6: Warterror90 (€6.66 in chips) 
Macantoni: posts small blind €0.01
mashallahh: posts big blind €0.02
*** HOLE CARDS ***
Dealt to caduceus369 [4h 3d]
caduceus369: folds 
ormaxam: folds 
Warterror90: raises €0.04 to €0.06
Begimon: folds 
Macantoni: calls €0.05
mashallahh: folds 
*** FLOP *** [6c Kc As]
Macantoni: bets €0.04
Warterror90: raises €0.08 to €0.12
Macantoni: folds 
Uncalled bet (€0.08) returned to Warterror90
Warterror90 collected €0.21 from pot
Warterror90: doesn't show hand 
*** SUMMARY ***
Total pot €0.22 | Rake €0.01 
Board [6c Kc As]
Seat 1: Begimon (button) folded before Flop (didn't bet)
Seat 2: Macantoni (small blind) folded on the Flop
Seat 3: mashallahh (big blind) folded before Flop
Seat 4: caduceus369 folded before Flop (didn't bet)
Seat 5: ormaxam folded before Flop (didn't bet)
Seat 6: Warterror90 collected (€0.21)



PokerStars Zoom Hand #258129207615:  Hold'em No Limit (€0.01/€0.02) [ADM ID: M62C63044C87BABT] - 2025/10/15 1:13:22 CET [2025/10/14 19:13:22 ET]
Table 'Sirio' 6-max Seat #1 is the button
Seat 1: caduceus369 (€2.83 in chips) 
Seat 2: father2008 (€2 in chips) 
Seat 3: ilteatro131 (€1.38 in chips) 
Seat 4: Warterror90 (€7.43 in chips) 
Seat 5: Begimon (€11.29 in chips) 
Seat 6: mashallahh (€2.84 in chips) 
father2008: posts small blind €0.01
ilteatro131: posts big blind €0.02
*** HOLE CARDS ***
Dealt to caduceus369 [Kh 6h]
Warterror90: folds 
Begimon: calls €0.02
mashallahh: folds 
caduceus369: folds 
father2008: folds 
ilteatro131: checks 
*** FLOP *** [Kd 9s Th]
ilteatro131: checks 
Begimon: bets €0.02
ilteatro131: folds 
Uncalled bet (€0.02) returned to Begimon
Begimon collected €0.05 from pot
Begimon: doesn't show hand 
*** SUMMARY ***
Total pot €0.05 | Rake €0 
Board [Kd 9s Th]
Seat 1: caduceus369 (button) folded before Flop (didn't bet)
Seat 2: father2008 (small blind) folded before Flop
Seat 3: ilteatro131 (big blind) folded on the Flop
Seat 4: Warterror90 folded before Flop (didn't bet)
Seat 5: Begimon collected (€0.05)
Seat 6: mashallahh folded before Flop (didn't bet)



PokerStars Zoom Hand #258129205271:  Hold'em No Limit (€0.01/€0.02) [ADM ID: M62C63044C87BABT] - 2025/10/15 1:13:08 CET [2025/10/14 19:13:08 ET]
Table 'Sirio' 6-max Seat #1 is the button
Seat 1: mashallahh (€7.94 in chips) 
Seat 2: CIKO71131 (€0.78 in chips) 
Seat 3: EasyToRule (€2.16 in chips) 
Seat 4: father2008 (€2 in chips) 
Seat 5: caduceus369 (€2.83 in chips) 
Seat 6: meteco79 (€0.93 in chips) 
CIKO71131: posts small blind €0.01
EasyToRule: posts big blind €0.02
*** HOLE CARDS ***
Dealt to caduceus369 [Td 6h]
father2008: folds 
caduceus369: folds 
meteco79: calls €0.02
mashallahh: folds 
CIKO71131: calls €0.01
EasyToRule: checks 
*** FLOP *** [2d 4d Kh]
CIKO71131: checks 
EasyToRule: checks 
meteco79: checks 
*** TURN *** [2d 4d Kh] [Th]
CIKO71131: checks 
EasyToRule: checks 
meteco79: checks 
*** RIVER *** [2d 4d Kh Th] [9s]
CIKO71131: checks 
EasyToRule: checks 
meteco79: bets €0.02
CIKO71131: folds 
EasyToRule: folds 
Uncalled bet (€0.02) returned to meteco79
meteco79 collected €0.06 from pot
meteco79: doesn't show hand 
*** SUMMARY ***
Total pot €0.06 | Rake €0 
Board [2d 4d Kh Th 9s]
Seat 1: mashallahh (button) folded before Flop (didn't bet)
Seat 2: CIKO71131 (small blind) folded on the River
Seat 3: EasyToRule (big blind) folded on the River
Seat 4: father2008 folded before Flop (didn't bet)
Seat 5: caduceus369 folded before Flop (didn't bet)
Seat 6: meteco79 collected (€0.06)



PokerStars Zoom Hand #258129206331:  Hold'em No Limit (€0.01/€0.02) [ADM ID: M62C63044C87BABT] - 2025/10/15 1:13:14 CET [2025/10/14 19:13:14 ET]
Table 'Sirio' 6-max Seat #1 is the button
Seat 1: Rrrr322 (€1.60 in chips) 
Seat 2: SebaRapy14 (€3.97 in chips) 
Seat 3: mashallahh (€7.94 in chips) 
Seat 4: caduceus369 (€2.83 in chips) 
Seat 5: Begimon (€11.29 in chips) 
Seat 6: CIKO71131 (€0.87 in chips) 
SebaRapy14: posts small blind €0.01
mashallahh: posts big blind €0.02
*** HOLE CARDS ***
Dealt to caduceus369 [3c 3s]
caduceus369: folds 
Begimon: folds 
CIKO71131: calls €0.02
Rrrr322: calls €0.02
SebaRapy14: folds 
mashallahh: checks 
*** FLOP *** [Js 7d 4c]
mashallahh: checks 
CIKO71131: checks 
Rrrr322: bets €0.04
mashallahh: folds 
CIKO71131: calls €0.04
*** TURN *** [Js 7d 4c] [4h]
CIKO71131: checks 
Rrrr322: bets €0.04
CIKO71131: calls €0.04
*** RIVER *** [Js 7d 4c 4h] [7h]
CIKO71131: checks 
Rrrr322: bets €0.20
CIKO71131: folds 
Uncalled bet (€0.20) returned to Rrrr322
Rrrr322 collected €0.22 from pot
Rrrr322: doesn't show hand 
*** SUMMARY ***
Total pot €0.23 | Rake €0.01 
Board [Js 7d 4c 4h 7h]
Seat 1: Rrrr322 (button) collected (€0.22)
Seat 2: SebaRapy14 (small blind) folded before Flop
Seat 3: mashallahh (big blind) folded on the Flop
Seat 4: caduceus369 folded before Flop (didn't bet)
Seat 5: Begimon folded before Flop (didn't bet)
Seat 6: CIKO71131 folded on the River



PokerStars Zoom Hand #258129209434:  Hold'em No Limit (€0.01/€0.02) [ADM ID: M62C63044C87BABT] - 2025/10/15 1:13:32 CET [2025/10/14 19:13:32 ET]
Table 'Sirio' 6-max Seat #1 is the button
Seat 1: mashallahh (€5.20 in chips) 
Seat 2: Warterror90 (€6.77 in chips) 
Seat 3: caduceus369 (€2.83 in chips) 
Seat 4: Temait77728 (€1.85 in chips) 
Seat 5: miridersa (€2.03 in chips) 
Seat 6: father2008 (€2 in chips) 
Warterror90: posts small blind €0.01
caduceus369: posts big blind €0.02
*** HOLE CARDS ***
Dealt to caduceus369 [4h Qc]
Temait77728: folds 
miridersa: calls €0.02
father2008: folds 
mashallahh: folds 
Warterror90: calls €0.01
caduceus369: checks 
*** FLOP *** [6h Jh 4c]
Warterror90: checks 
caduceus369: checks 
miridersa: checks 
*** TURN *** [6h Jh 4c] [2s]
Warterror90: checks 
caduceus369: checks 
miridersa: checks 
*** RIVER *** [6h Jh 4c 2s] [5d]
Warterror90: bets €0.08
caduceus369: folds 
miridersa: folds 
Uncalled bet (€0.08) returned to Warterror90
Warterror90 collected €0.06 from pot
Warterror90: doesn't show hand 
*** SUMMARY ***
Total pot €0.06 | Rake €0 
Board [6h Jh 4c 2s 5d]
Seat 1: mashallahh (button) folded before Flop (didn't bet)
Seat 2: Warterror90 (small blind) collected (€0.06)
Seat 3: caduceus369 (big blind) folded on the River
Seat 4: Temait77728 folded before Flop (didn't bet)
Seat 5: miridersa folded on the River
Seat 6: father2008 folded before Flop (didn't bet)



PokerStars Zoom Hand #258129221832:  Hold'em No Limit (€0.01/€0.02) [ADM ID: M62C63044C87BABT] - 2025/10/15 1:14:47 CET [2025/10/14 19:14:47 ET]
Table 'Sirio' 6-max Seat #1 is the button
Seat 1: mashallahh (€8.62 in chips) 
Seat 2: caduceus369 (€2.81 in chips) 
Seat 3: CIKO71131 (€0.75 in chips) 
Seat 4: ADRIAN0_MEIS (€6.24 in chips) 
Seat 5: franck19621962 (€0.92 in chips) 
Seat 6: miridersa (€2 in chips) 
caduceus369: posts small blind €0.01
CIKO71131: posts big blind €0.02
*** HOLE CARDS ***
Dealt to caduceus369 [6h 5c]
ADRIAN0_MEIS: folds 
franck19621962: folds 
miridersa: folds 
mashallahh: folds 
caduceus369: folds 
Uncalled bet (€0.01) returned to CIKO71131
CIKO71131 collected €0.02 from pot
CIKO71131: doesn't show hand 
*** SUMMARY ***
Total pot €0.02 | Rake €0 
Seat 1: mashallahh (button) folded before Flop (didn't bet)
Seat 2: caduceus369 (small blind) folded before Flop
Seat 3: CIKO71131 (big blind) collected (€0.02)
Seat 4: ADRIAN0_MEIS folded before Flop (didn't bet)
Seat 5: franck19621962 folded before Flop (didn't bet)
Seat 6: miridersa folded before Flop (didn't bet)



PokerStars Zoom Hand #258129220487:  Hold'em No Limit (€0.01/€0.02) [ADM ID: M62C63044C87BABT] - 2025/10/15 1:14:39 CET [2025/10/14 19:14:39 ET]
Table 'Sirio' 6-max Seat #1 is the button
Seat 1: miridersa (€2 in chips) 
Seat 2: JACK96997 (€2 in chips) 
Seat 3: Trezvenik93 (€3.78 in chips) 
Seat 4: uziu47 (€1.38 in chips) 
Seat 5: caduceus369 (€2.81 in chips) 
Seat 6: bartolo608 (€1.79 in chips) 
JACK96997: posts small blind €0.01
Trezvenik93: posts big blind €0.02
*** HOLE CARDS ***
Dealt to caduceus369 [4c 6h]
uziu47: folds 
caduceus369: folds 
bartolo608: calls €0.02
miridersa: folds 
JACK96997: folds 
Trezvenik93: checks 
*** FLOP *** [Ts Td Kc]
Trezvenik93: checks 
bartolo608: checks 
*** TURN *** [Ts Td Kc] [3c]
Trezvenik93: checks 
bartolo608: checks 
*** RIVER *** [Ts Td Kc 3c] [Jd]
Trezvenik93: checks 
bartolo608: bets €0.06
Trezvenik93: folds 
Uncalled bet (€0.06) returned to bartolo608
bartolo608 collected €0.05 from pot
bartolo608: doesn't show hand 
*** SUMMARY ***
Total pot €0.05 | Rake €0 
Board [Ts Td Kc 3c Jd]
Seat 1: miridersa (button) folded before Flop (didn't bet)
Seat 2: JACK96997 (small blind) folded before Flop
Seat 3: Trezvenik93 (big blind) folded on the River
Seat 4: uziu47 folded before Flop (didn't bet)
Seat 5: caduceus369 folded before Flop (didn't bet)
Seat 6: bartolo608 collected (€0.05)



PokerStars Zoom Hand #258129223861:  Hold'em No Limit (€0.01/€0.02) [ADM ID: M62C63044C87BABT] - 2025/10/15 1:14:59 CET [2025/10/14 19:14:59 ET]
Table 'Sirio' 6-max Seat #1 is the button
Seat 1: franck19621962 (€0.91 in chips) 
Seat 2: Begimon (€11.60 in chips) 
Seat 3: dandoshats (€2.16 in chips) 
Seat 4: BiscottinoXXL (€2.03 in chips) 
Seat 5: Trezvenik93 (€2 in chips) 
Seat 6: caduceus369 (€2.80 in chips) 
Begimon: posts small blind €0.01
dandoshats: posts big blind €0.02
*** HOLE CARDS ***
Dealt to caduceus369 [Th 4s]
BiscottinoXXL: folds 
Trezvenik93: folds 
caduceus369: folds 
franck19621962: calls €0.02
Begimon: calls €0.01
dandoshats: checks 
*** FLOP *** [Ac 7h 3s]
Begimon: checks 
dandoshats: checks 
franck19621962: checks 
*** TURN *** [Ac 7h 3s] [3d]
Begimon: checks 
dandoshats: checks 
franck19621962: checks 
*** RIVER *** [Ac 7h 3s 3d] [9d]
Begimon: checks 
dandoshats: bets €0.03
franck19621962: folds 
Begimon: folds 
Uncalled bet (€0.03) returned to dandoshats
dandoshats collected €0.06 from pot
dandoshats: doesn't show hand 
*** SUMMARY ***
Total pot €0.06 | Rake €0 
Board [Ac 7h 3s 3d 9d]
Seat 1: franck19621962 (button) folded on the River
Seat 2: Begimon (small blind) folded on the River
Seat 3: dandoshats (big blind) collected (€0.06)
Seat 4: BiscottinoXXL folded before Flop (didn't bet)
Seat 5: Trezvenik93 folded before Flop (didn't bet)
Seat 6: caduceus369 folded before Flop (didn't bet)



PokerStars Zoom Hand #258129225512:  Hold'em No Limit (€0.01/€0.02) [ADM ID: M62C63044C87BABT] - 2025/10/15 1:15:08 CET [2025/10/14 19:15:08 ET]
Table 'Sirio' 6-max Seat #1 is the button
Seat 1: Trezvenik93 (€3.76 in chips) 
Seat 2: Warterror90 (€7.67 in chips) 
Seat 3: SebaRapy14 (€4.97 in chips) 
Seat 4: mashallahh (€8.61 in chips) 
Seat 5: caduceus369 (€2.80 in chips) 
Seat 6: EasyToRule (€2.13 in chips) 
Warterror90: posts small blind €0.01
SebaRapy14: posts big blind €0.02
*** HOLE CARDS ***
Dealt to caduceus369 [8d Th]
mashallahh: folds 
caduceus369: folds 
EasyToRule: raises €0.03 to €0.05
Trezvenik93: folds 
Warterror90: raises €0.10 to €0.15
SebaRapy14: folds 
EasyToRule: calls €0.10
*** FLOP *** [Qh Ts 4c]
Warterror90: checks 
EasyToRule: checks 
*** TURN *** [Qh Ts 4c] [Jd]
Warterror90: bets €0.12
EasyToRule: folds 
Uncalled bet (€0.12) returned to Warterror90
Warterror90 collected €0.31 from pot
Warterror90: doesn't show hand 
*** SUMMARY ***
Total pot €0.32 | Rake €0.01 
Board [Qh Ts 4c Jd]
Seat 1: Trezvenik93 (button) folded before Flop (didn't bet)
Seat 2: Warterror90 (small blind) collected (€0.31)
Seat 3: SebaRapy14 (big blind) folded before Flop
Seat 4: mashallahh folded before Flop (didn't bet)
Seat 5: caduceus369 folded before Flop (didn't bet)
Seat 6: EasyToRule folded on the Turn



PokerStars Zoom Hand #258129223200:  Hold'em No Limit (€0.01/€0.02) [ADM ID: M62C63044C87BABT] - 2025/10/15 1:14:55 CET [2025/10/14 19:14:55 ET]
Table 'Sirio' 6-max Seat #1 is the button
Seat 1: caduceus369 (€2.80 in chips) 
Seat 2: mashallahh (€8.62 in chips) 
Seat 3: father2008 (€2.88 in chips) 
Seat 4: QUEEN-KING-QQKK (€1.42 in chips) 
Seat 5: Temait77728 (€1.84 in chips) 
Seat 6: miridersa (€2 in chips) 
mashallahh: posts small blind €0.01
father2008: posts big blind €0.02
*** HOLE CARDS ***
Dealt to caduceus369 [7d 6d]
QUEEN-KING-QQKK: calls €0.02
Temait77728: folds 
miridersa: calls €0.02
caduceus369: folds 
mashallahh: folds 
father2008: checks 
*** FLOP *** [3h 9s Ks]
father2008: checks 
QUEEN-KING-QQKK: bets €0.07
miridersa: raises €0.21 to €0.28
father2008: folds 
QUEEN-KING-QQKK: calls €0.21
*** TURN *** [3h 9s Ks] [4h]
QUEEN-KING-QQKK: checks 
miridersa: bets €0.60
QUEEN-KING-QQKK: calls €0.60
*** RIVER *** [3h 9s Ks 4h] [7s]
QUEEN-KING-QQKK: bets €0.52 and is all-in
miridersa: calls €0.52
*** SHOW DOWN ***
QUEEN-KING-QQKK: shows [3s 6s] (a flush, King high)
miridersa: shows [Kc 9d] (two pair, Kings and Nines)
QUEEN-KING-QQKK collected €2.72 from pot
*** SUMMARY ***
Total pot €2.87 | Rake €0.15 
Board [3h 9s Ks 4h 7s]
Seat 1: caduceus369 (button) folded before Flop (didn't bet)
Seat 2: mashallahh (small blind) folded before Flop
Seat 3: father2008 (big blind) folded on the Flop
Seat 4: QUEEN-KING-QQKK showed [3s 6s] and won (€2.72) with a flush, King high
Seat 5: Temait77728 folded before Flop (didn't bet)
Seat 6: miridersa showed [Kc 9d] and lost with two pair, Kings and Nines



PokerStars Zoom Hand #258129226487:  Hold'em No Limit (€0.01/€0.02) [ADM ID: M62C63044C87BABT] - 2025/10/15 1:15:14 CET [2025/10/14 19:15:14 ET]
Table 'Sirio' 6-max Seat #1 is the button
Seat 1: bv0360 (€1.26 in chips) 
Seat 2: uziu47 (€1.36 in chips) 
Seat 3: caduceus369 (€2.80 in chips) 
Seat 4: mashallahh (€8.61 in chips) 
Seat 5: bartolo608 (€1.82 in chips) 
Seat 6: Trezvenik93 (€3.76 in chips) 
uziu47: posts small blind €0.01
caduceus369: posts big blind €0.02
*** HOLE CARDS ***
Dealt to caduceus369 [Jd Js]
mashallahh: folds 
bartolo608: calls €0.02
Trezvenik93: folds 
bv0360: calls €0.02
uziu47: calls €0.01
caduceus369: raises €0.12 to €0.14
bartolo608: folds 
bv0360: calls €0.12
uziu47: folds 
*** FLOP *** [6s 9c Ac]
caduceus369: bets €0.18
bv0360: calls €0.18
*** TURN *** [6s 9c Ac] [5s]
caduceus369: checks 
bv0360: checks 
*** RIVER *** [6s 9c Ac 5s] [4s]
caduceus369: checks 
bv0360: bets €0.65
caduceus369: folds 
Uncalled bet (€0.65) returned to bv0360
bv0360 collected €0.65 from pot
bv0360: doesn't show hand 
*** SUMMARY ***
Total pot €0.68 | Rake €0.03 
Board [6s 9c Ac 5s 4s]
Seat 1: bv0360 (button) collected (€0.65)
Seat 2: uziu47 (small blind) folded before Flop
Seat 3: caduceus369 (big blind) folded on the River
Seat 4: mashallahh folded before Flop (didn't bet)
Seat 5: bartolo608 folded before Flop
Seat 6: Trezvenik93 folded before Flop (didn't bet)



PokerStars Zoom Hand #258129234641:  Hold'em No Limit (€0.01/€0.02) [ADM ID: M62C63044C87BABT] - 2025/10/15 1:16:02 CET [2025/10/14 19:16:02 ET]
Table 'Sirio' 6-max Seat #1 is the button
Seat 1: EasyToRule (€2 in chips) 
Seat 2: Temait77728 (€1.85 in chips) 
Seat 3: QUEEN-KING-QQKK (€2.72 in chips) 
Seat 4: father2008 (€2 in chips) 
Seat 5: BiscottinoXXL (€3.89 in chips) 
Seat 6: caduceus369 (€2.48 in chips) 
Temait77728: posts small blind €0.01
QUEEN-KING-QQKK: posts big blind €0.02
*** HOLE CARDS ***
Dealt to caduceus369 [Qs Jd]
father2008: folds 
BiscottinoXXL: folds 
caduceus369: raises €0.04 to €0.06
EasyToRule: folds 
Temait77728: calls €0.05
QUEEN-KING-QQKK: folds 
*** FLOP *** [6c 2d 9s]
Temait77728: checks 
caduceus369: checks 
*** TURN *** [6c 2d 9s] [Ad]
Temait77728: checks 
caduceus369: bets €0.04
Temait77728: calls €0.04
*** RIVER *** [6c 2d 9s Ad] [4h]
Temait77728: checks 
caduceus369: checks 
*** SHOW DOWN ***
Temait77728: shows [8h 9h] (a pair of Nines)
caduceus369: mucks hand 
Temait77728 collected €0.21 from pot
*** SUMMARY ***
Total pot €0.22 | Rake €0.01 
Board [6c 2d 9s Ad 4h]
Seat 1: EasyToRule (button) folded before Flop (didn't bet)
Seat 2: Temait77728 (small blind) showed [8h 9h] and won (€0.21) with a pair of Nines
Seat 3: QUEEN-KING-QQKK (big blind) folded before Flop
Seat 4: father2008 folded before Flop (didn't bet)
Seat 5: BiscottinoXXL folded before Flop (didn't bet)
Seat 6: caduceus369 mucked [Qs Jd]



PokerStars Zoom Hand #258129243120:  Hold'em No Limit (€0.01/€0.02) [ADM ID: M62C63044C87BABT] - 2025/10/15 1:16:53 CET [2025/10/14 19:16:53 ET]
Table 'Sirio' 6-max Seat #1 is the button
Seat 1: Rrrr322 (€1.10 in chips) 
Seat 2: mashallahh (€7.64 in chips) 
Seat 3: dandoshats (€2.57 in chips) 
Seat 4: father2008 (€2.82 in chips) 
Seat 5: BiscottinoXXL (€2 in chips) 
Seat 6: caduceus369 (€2.37 in chips) 
mashallahh: posts small blind €0.01
dandoshats: posts big blind €0.02
*** HOLE CARDS ***
Dealt to caduceus369 [2d 6d]
father2008: folds 
BiscottinoXXL: folds 
caduceus369: folds 
Rrrr322: calls €0.02
mashallahh: folds 
dandoshats: checks 
*** FLOP *** [2h 4c Qc]
dandoshats: checks 
Rrrr322: checks 
*** TURN *** [2h 4c Qc] [4d]
dandoshats: checks 
Rrrr322: checks 
*** RIVER *** [2h 4c Qc 4d] [Td]
dandoshats: bets €0.02
Rrrr322: calls €0.02
*** SHOW DOWN ***
dandoshats: shows [5c 8d] (a pair of Fours)
Rrrr322: shows [6c Ks] (a pair of Fours - King kicker)
Rrrr322 collected €0.09 from pot
*** SUMMARY ***
Total pot €0.09 | Rake €0 
Board [2h 4c Qc 4d Td]
Seat 1: Rrrr322 (button) showed [6c Ks] and won (€0.09) with a pair of Fours
Seat 2: mashallahh (small blind) folded before Flop
Seat 3: dandoshats (big blind) showed [5c 8d] and lost with a pair of Fours
Seat 4: father2008 folded before Flop (didn't bet)
Seat 5: BiscottinoXXL folded before Flop (didn't bet)
Seat 6: caduceus369 folded before Flop (didn't bet)



PokerStars Zoom Hand #258129240077:  Hold'em No Limit (€0.01/€0.02) [ADM ID: M62C63044C87BABT] - 2025/10/15 1:16:34 CET [2025/10/14 19:16:34 ET]
Table 'Sirio' 6-max Seat #1 is the button
Seat 1: BiscottinoXXL (€3.87 in chips) 
Seat 2: caduceus369 (€2.38 in chips) 
Seat 3: Temait77728 (€1.96 in chips) 
Seat 4: Warterror90 (€2.84 in chips) 
Seat 5: EasyToRule (€2 in chips) 
Seat 6: uziu47 (€1.41 in chips) 
caduceus369: posts small blind €0.01
Temait77728: posts big blind €0.02
*** HOLE CARDS ***
Dealt to caduceus369 [9s 8s]
Warterror90: raises €0.04 to €0.06
EasyToRule: folds 
uziu47: calls €0.06
BiscottinoXXL: folds 
caduceus369: folds 
Temait77728: folds 
*** FLOP *** [Qs As Tc]
Warterror90: checks 
uziu47: checks 
*** TURN *** [Qs As Tc] [6d]
Warterror90: bets €0.06
uziu47: calls €0.06
*** RIVER *** [Qs As Tc 6d] [6c]
Warterror90: bets €0.09
uziu47: calls €0.09
*** SHOW DOWN ***
Warterror90: shows [3d Ac] (two pair, Aces and Sixes)
uziu47: mucks hand 
Warterror90 collected €0.43 from pot
*** SUMMARY ***
Total pot €0.45 | Rake €0.02 
Board [Qs As Tc 6d 6c]
Seat 1: BiscottinoXXL (button) folded before Flop (didn't bet)
Seat 2: caduceus369 (small blind) folded before Flop
Seat 3: Temait77728 (big blind) folded before Flop
Seat 4: Warterror90 showed [3d Ac] and won (€0.43) with two pair, Aces and Sixes
Seat 5: EasyToRule folded before Flop (didn't bet)
Seat 6: uziu47 mucked [Th 9h]



PokerStars Zoom Hand #258129241498:  Hold'em No Limit (€0.01/€0.02) [ADM ID: M62C63044C87BABT] - 2025/10/15 1:16:43 CET [2025/10/14 19:16:43 ET]
Table 'Sirio' 6-max Seat #1 is the button
Seat 1: caduceus369 (€2.37 in chips) 
Seat 2: dandoshats (€2.58 in chips) 
Seat 3: CIKO71131 (€0.80 in chips) 
Seat 4: miridersa (€0.64 in chips) 
Seat 5: SebaRapy14 (€5.28 in chips) 
Seat 6: father2008 (€2.82 in chips) 
dandoshats: posts small blind €0.01
CIKO71131: posts big blind €0.02
*** HOLE CARDS ***
Dealt to caduceus369 [7c 8s]
miridersa: raises €0.02 to €0.04
SebaRapy14: calls €0.04
father2008: folds 
caduceus369: folds 
dandoshats: folds 
CIKO71131: calls €0.02
*** FLOP *** [5s As 3h]
CIKO71131: checks 
miridersa: bets €0.02
SebaRapy14: folds 
CIKO71131: calls €0.02
*** TURN *** [5s As 3h] [Jh]
CIKO71131: checks 
miridersa: checks 
*** RIVER *** [5s As 3h Jh] [8h]
CIKO71131: checks 
miridersa: checks 
*** SHOW DOWN ***
CIKO71131: shows [9s 4d] (high card Ace)
miridersa: shows [4s Kc] (high card Ace - King kicker)
miridersa collected €0.17 from pot
*** SUMMARY ***
Total pot €0.17 | Rake €0 
Board [5s As 3h Jh 8h]
Seat 1: caduceus369 (button) folded before Flop (didn't bet)
Seat 2: dandoshats (small blind) folded before Flop
Seat 3: CIKO71131 (big blind) showed [9s 4d] and lost with high card Ace
Seat 4: miridersa showed [4s Kc] and won (€0.17) with high card Ace
Seat 5: SebaRapy14 folded on the Flop
Seat 6: father2008 folded before Flop (didn't bet)



PokerStars Zoom Hand #258129240602:  Hold'em No Limit (€0.01/€0.02) [ADM ID: M62C63044C87BABT] - 2025/10/15 1:16:37 CET [2025/10/14 19:16:37 ET]
Table 'Sirio' 6-max Seat #1 is the button
Seat 1: Poetto65 (€0.60 in chips) 
Seat 2: father2008 (€2 in chips) 
Seat 3: ADRIAN0_MEIS (€6.30 in chips) 
Seat 4: caduceus369 (€2.37 in chips) 
Seat 5: QUEEN-KING-QQKK (€2.66 in chips) 
Seat 6: BiscottinoXXL (€3.87 in chips) 
father2008: posts small blind €0.01
ADRIAN0_MEIS: posts big blind €0.02
*** HOLE CARDS ***
Dealt to caduceus369 [Jd 5h]
caduceus369: folds 
QUEEN-KING-QQKK: raises €0.02 to €0.04
BiscottinoXXL: folds 
Poetto65: folds 
father2008: calls €0.03
ADRIAN0_MEIS: calls €0.02
*** FLOP *** [7s 3d 4c]
father2008: checks 
ADRIAN0_MEIS: checks 
QUEEN-KING-QQKK: bets €0.10
father2008: folds 
ADRIAN0_MEIS: raises €0.11 to €0.21
QUEEN-KING-QQKK: calls €0.11
*** TURN *** [7s 3d 4c] [3c]
ADRIAN0_MEIS: bets €0.29
QUEEN-KING-QQKK: folds 
Uncalled bet (€0.29) returned to ADRIAN0_MEIS
ADRIAN0_MEIS collected €0.52 from pot
ADRIAN0_MEIS: doesn't show hand 
*** SUMMARY ***
Total pot €0.54 | Rake €0.02 
Board [7s 3d 4c 3c]
Seat 1: Poetto65 (button) folded before Flop (didn't bet)
Seat 2: father2008 (small blind) folded on the Flop
Seat 3: ADRIAN0_MEIS (big blind) collected (€0.52)
Seat 4: caduceus369 folded before Flop (didn't bet)
Seat 5: QUEEN-KING-QQKK folded on the Turn
Seat 6: BiscottinoXXL folded before Flop (didn't bet)



PokerStars Zoom Hand #258129245496:  Hold'em No Limit (€0.01/€0.02) [ADM ID: M62C63044C87BABT] - 2025/10/15 1:17:07 CET [2025/10/14 19:17:07 ET]
Table 'Sirio' 6-max Seat #1 is the button
Seat 1: bartolo608 (€0.95 in chips) 
Seat 2: Crock361 (€1.98 in chips) 
Seat 3: caduceus369 (€2.36 in chips) 
Seat 4: EasyToRule (€2.03 in chips) 
Seat 5: QUEEN-KING-QQKK (€2.85 in chips) 
Seat 6: Temait77728 (€1.94 in chips) 
Crock361: posts small blind €0.01
caduceus369: posts big blind €0.02
*** HOLE CARDS ***
Dealt to caduceus369 [2c 9h]
EasyToRule: folds 
QUEEN-KING-QQKK: folds 
Temait77728: raises €0.05 to €0.07
bartolo608: folds 
Crock361: folds 
caduceus369: folds 
Uncalled bet (€0.05) returned to Temait77728
Temait77728 collected €0.05 from pot
Temait77728: doesn't show hand 
*** SUMMARY ***
Total pot €0.05 | Rake €0 
Seat 1: bartolo608 (button) folded before Flop (didn't bet)
Seat 2: Crock361 (small blind) folded before Flop
Seat 3: caduceus369 (big blind) folded before Flop
Seat 4: EasyToRule folded before Flop (didn't bet)
Seat 5: QUEEN-KING-QQKK folded before Flop (didn't bet)
Seat 6: Temait77728 collected (€0.05)



PokerStars Zoom Hand #258129243812:  Hold'em No Limit (€0.01/€0.02) [ADM ID: M62C63044C87BABT] - 2025/10/15 1:16:56 CET [2025/10/14 19:16:56 ET]
Table 'Sirio' 6-max Seat #1 is the button
Seat 1: ilteatro131 (€1.15 in chips) 
Seat 2: caduceus369 (€2.37 in chips) 
Seat 3: BiscottinoXXL (€2 in chips) 
Seat 4: franck19621962 (€1.04 in chips) 
Seat 5: mashallahh (€7.63 in chips) 
Seat 6: bv0360 (€1.43 in chips) 
caduceus369: posts small blind €0.01
BiscottinoXXL: posts big blind €0.02
*** HOLE CARDS ***
Dealt to caduceus369 [9h Kd]
franck19621962: folds 
mashallahh: folds 
bv0360: calls €0.02
ilteatro131: calls €0.02
caduceus369: folds 
BiscottinoXXL: checks 
*** FLOP *** [2h 3s 9c]
BiscottinoXXL: checks 
bv0360: checks 
ilteatro131: checks 
*** TURN *** [2h 3s 9c] [7s]
BiscottinoXXL: checks 
bv0360: checks 
ilteatro131: checks 
*** RIVER *** [2h 3s 9c 7s] [7d]
ilteatro131 is disconnected 
BiscottinoXXL: checks 
bv0360: checks 
ilteatro131 has timed out while disconnected
ilteatro131: checks 
*** SHOW DOWN ***
BiscottinoXXL: shows [Ts 4d] (a pair of Sevens)
bv0360: mucks hand 
ilteatro131: shows [Qc Td] (a pair of Sevens - Queen kicker)
ilteatro131 collected €0.07 from pot
*** SUMMARY ***
Total pot €0.07 | Rake €0 
Board [2h 3s 9c 7s 7d]
Seat 1: ilteatro131 (button) showed [Qc Td] and won (€0.07) with a pair of Sevens
Seat 2: caduceus369 (small blind) folded before Flop
Seat 3: BiscottinoXXL (big blind) showed [Ts 4d] and lost with a pair of Sevens
Seat 4: franck19621962 folded before Flop (didn't bet)
Seat 5: mashallahh folded before Flop (didn't bet)
Seat 6: bv0360 mucked [8c 6d]



PokerStars Zoom Hand #258129247934:  Hold'em No Limit (€0.01/€0.02) [ADM ID: M62C63044C87BABT] - 2025/10/15 1:17:20 CET [2025/10/14 19:17:20 ET]
Table 'Sirio' 6-max Seat #1 is the button
Seat 1: CIKO71131 (€0.74 in chips) 
Seat 2: mashallahh (€3.90 in chips) 
Seat 3: SebaRapy14 (€5.24 in chips) 
Seat 4: caduceus369 (€2.34 in chips) 
Seat 5: father2008 (€2.80 in chips) 
Seat 6: Warterror90 (€3.06 in chips) 
mashallahh: posts small blind €0.01
SebaRapy14: posts big blind €0.02
*** HOLE CARDS ***
Dealt to caduceus369 [2s 9d]
caduceus369: folds 
father2008: folds 
Warterror90: raises €0.04 to €0.06
CIKO71131: folds 
mashallahh: raises €0.12 to €0.18
SebaRapy14: folds 
Warterror90: calls €0.12
*** FLOP *** [Th Ts Td]
mashallahh: bets €0.24
Warterror90: folds 
Uncalled bet (€0.24) returned to mashallahh
mashallahh collected €0.36 from pot
mashallahh: doesn't show hand 
*** SUMMARY ***
Total pot €0.38 | Rake €0.02 
Board [Th Ts Td]
Seat 1: CIKO71131 (button) folded before Flop (didn't bet)
Seat 2: mashallahh (small blind) collected (€0.36)
Seat 3: SebaRapy14 (big blind) folded before Flop
Seat 4: caduceus369 folded before Flop (didn't bet)
Seat 5: father2008 folded before Flop (didn't bet)
Seat 6: Warterror90 folded on the Flop



PokerStars Zoom Hand #258129250599:  Hold'em No Limit (€0.01/€0.02) [ADM ID: M62C63044C87BABT] - 2025/10/15 1:17:37 CET [2025/10/14 19:17:37 ET]
Table 'Sirio' 6-max Seat #1 is the button
Seat 1: uziu47 (€1.19 in chips) 
Seat 2: father2008 (€2.80 in chips) 
Seat 3: Begimon (€11.56 in chips) 
Seat 4: Warterror90 (€6.73 in chips) 
Seat 5: caduceus369 (€2.34 in chips) 
Seat 6: EasyToRule (€2.16 in chips) 
father2008: posts small blind €0.01
Begimon: posts big blind €0.02
*** HOLE CARDS ***
Dealt to caduceus369 [8c 8s]
Warterror90: raises €0.04 to €0.06
caduceus369: calls €0.06
EasyToRule: raises €0.17 to €0.23
uziu47: folds 
father2008: folds 
Begimon: folds 
Warterror90: calls €0.17
caduceus369: calls €0.17
*** FLOP *** [8d 9h 9d]
Warterror90: checks 
caduceus369: checks 
EasyToRule: checks 
*** TURN *** [8d 9h 9d] [3s]
Warterror90: checks 
caduceus369: bets €0.15
EasyToRule: calls €0.15
Warterror90: calls €0.15
*** RIVER *** [8d 9h 9d 3s] [Qs]
Warterror90: checks 
caduceus369: bets €0.34
EasyToRule: calls €0.34
Warterror90: calls €0.34
*** SHOW DOWN ***
caduceus369: shows [8c 8s] (a full house, Eights full of Nines)
EasyToRule: mucks hand 
Warterror90: mucks hand 
caduceus369 collected €2.07 from pot
*** SUMMARY ***
Total pot €2.19 | Rake €0.12 
Board [8d 9h 9d 3s Qs]
Seat 1: uziu47 (button) folded before Flop (didn't bet)
Seat 2: father2008 (small blind) folded before Flop
Seat 3: Begimon (big blind) folded before Flop
Seat 4: Warterror90 mucked [Qc Jc]
Seat 5: caduceus369 showed [8c 8s] and won (€2.07) with a full house, Eights full of Nines
Seat 6: EasyToRule mucked [Qd As]



PokerStars Zoom Hand #258129264771:  Hold'em No Limit (€0.01/€0.02) [ADM ID: M62C63044C87BABT] - 2025/10/15 1:19:00 CET [2025/10/14 19:19:00 ET]
Table 'Sirio' 6-max Seat #1 is the button
Seat 1: Elisa180286 (€1.52 in chips) 
Seat 2: la pisuline (€2 in chips) 
Seat 3: Rrrr322 (€1.55 in chips) 
Seat 4: caduceus369 (€3.69 in chips) 
Seat 5: Warterror90 (€7.70 in chips) 
Seat 6: QUEEN-KING-QQKK (€2.39 in chips) 
la pisuline: posts small blind €0.01
Rrrr322: posts big blind €0.02
*** HOLE CARDS ***
Dealt to caduceus369 [3h 4c]
caduceus369: folds 
Warterror90: raises €0.04 to €0.06
QUEEN-KING-QQKK: calls €0.06
Elisa180286: folds 
la pisuline: folds 
Rrrr322: calls €0.04
*** FLOP *** [Qh 9h Ad]
Rrrr322: checks 
Warterror90: bets €0.06
QUEEN-KING-QQKK: folds 
Rrrr322: folds 
Uncalled bet (€0.06) returned to Warterror90
Warterror90 collected €0.18 from pot
Warterror90: doesn't show hand 
*** SUMMARY ***
Total pot €0.19 | Rake €0.01 
Board [Qh 9h Ad]
Seat 1: Elisa180286 (button) folded before Flop (didn't bet)
Seat 2: la pisuline (small blind) folded before Flop
Seat 3: Rrrr322 (big blind) folded on the Flop
Seat 4: caduceus369 folded before Flop (didn't bet)
Seat 5: Warterror90 collected (€0.18)
Seat 6: QUEEN-KING-QQKK folded on the Flop



